noc,year,season,bronze_medals,gold_medals,silver_medals,total_medals
AFG,2008,Summer,1,0,0,1
AFG,2012,Summer,1,0,0,1
AHO,1988,Summer,0,0,1,1
ALG,1984,Summer,2,0,0,2
ALG,1992,Summer,1,1,0,2
ALG,1996,Summer,1,2,0,3
ALG,2000,Summer,3,1,1,5
ALG,2008,Summer,1,0,1,2
ALG,2012,Summer,0,1,0,1
ALG,2016,Summer,0,0,2,2
ANZ,1908,Summer,2,15,2,19
ANZ,1912,Summer,3,5,2,10
ARG,1924,Summer,2,5,3,10
ARG,1928,Summer,5,3,18,26
ARG,1932,Summer,0,3,1,4
ARG,1936,Summer,4,5,2,11
ARG,1948,Summer,1,3,7,11
ARG,1952,Summer,2,2,2,6
ARG,1956,Summer,1,0,1,2
ARG,1960,Summer,1,0,3,4
ARG,1964,Summer,0,0,1,1
ARG,1968,Summer,2,0,0,2
ARG,1972,Summer,0,0,1,1
ARG,1988,Summer,12,0,1,13
ARG,1992,Summer,2,0,0,2
ARG,1996,Summer,1,0,19,20
ARG,2000,Summer,3,0,17,20
ARG,2004,Summer,21,28,0,49
ARG,2008,Summer,31,20,0,51
ARG,2012,Summer,3,1,15,19
ARG,2016,Summer,0,21,1,22
ARM,1996,Summer,0,1,1,2
ARM,2000,Summer,1,0,0,1
ARM,2008,Summer,6,0,0,6
ARM,2012,Summer,2,0,1,3
ARM,2016,Summer,0,1,3,4
AUS,1896,Summer,1,2,0,3
AUS,1900,Summer,3,3,0,6
AUS,1904,Summer,1,0,3,4
AUS,1906,Summer,3,0,0,3
AUS,1920,Summer,1,0,6,7
AUS,1924,Summer,2,3,5,10
AUS,1924,Winter,0,1,0,1
AUS,1928,Summer,1,1,2,4
AUS,1932,Summer,1,3,1,5
AUS,1936,Summer,1,0,0,1
AUS,1948,Summer,5,2,9,16
AUS,1952,Summer,11,7,2,20
AUS,1956,Summer,26,28,13,67
AUS,1960,Summer,11,11,24,46
AUS,1964,Summer,30,8,6,44
AUS,1968,Summer,11,5,35,51
AUS,1972,Summer,2,11,7,20
AUS,1976,Summer,8,0,15,23
AUS,1980,Summer,5,6,2,13
AUS,1984,Summer,31,7,14,52
AUS,1988,Summer,11,18,6,35
AUS,1992,Summer,16,14,27,57
AUS,1994,Winter,4,0,0,4
AUS,1996,Summer,84,32,16,132
AUS,1998,Winter,1,0,0,1
AUS,2000,Summer,54,60,69,183
AUS,2002,Winter,0,2,0,2
AUS,2004,Summer,31,49,77,157
AUS,2006,Winter,1,1,0,2
AUS,2008,Summer,76,31,42,149
AUS,2010,Winter,0,2,1,3
AUS,2012,Summer,59,18,37,114
AUS,2014,Winter,1,0,2,3
AUS,2016,Summer,25,23,34,82
AUT,1896,Summer,2,2,1,5
AUT,1900,Summer,3,0,3,6
AUT,1904,Summer,1,2,1,4
AUT,1906,Summer,3,3,3,9
AUT,1908,Summer,1,0,0,1
AUT,1912,Summer,5,0,9,14
AUT,1924,Summer,1,0,3,4
AUT,1924,Winter,0,3,1,4
AUT,1928,Summer,2,3,0,5
AUT,1928,Winter,2,0,4,6
AUT,1932,Summer,3,1,1,5
AUT,1932,Winter,0,1,1,2
AUT,1936,Summer,7,6,42,55
AUT,1936,Winter,2,1,2,5
AUT,1948,Summer,4,2,2,8
AUT,1948,Winter,4,1,3,8
AUT,1952,Summer,2,0,1,3
AUT,1952,Winter,2,2,4,8
AUT,1956,Summer,4,0,0,4
AUT,1956,Winter,4,5,3,12
AUT,1960,Summer,0,1,2,3
AUT,1960,Winter,3,1,2,6
AUT,1964,Winter,3,5,9,17
AUT,1968,Summer,3,0,2,5
AUT,1968,Winter,4,3,8,15
AUT,1972,Summer,2,0,1,3
AUT,1972,Winter,2,1,2,5
AUT,1976,Summer,1,0,0,1
AUT,1976,Winter,3,2,2,7
AUT,1980,Summer,1,1,3,5
AUT,1980,Winter,3,3,2,8
AUT,1984,Summer,1,1,1,3
AUT,1984,Winter,1,0,0,1
AUT,1988,Summer,0,1,0,1
AUT,1988,Winter,4,3,5,12
AUT,1992,Summer,0,0,6,6
AUT,1992,Winter,10,9,10,29
AUT,1994,Winter,7,2,3,12
AUT,1996,Summer,2,0,1,3
AUT,1998,Winter,12,3,5,20
AUT,2000,Summer,0,3,1,4
AUT,2002,Winter,13,3,4,20
AUT,2004,Summer,1,3,4,8
AUT,2006,Winter,7,16,7,30
AUT,2008,Summer,2,0,1,3
AUT,2010,Winter,6,11,9,26
AUT,2014,Winter,11,4,12,27
AUT,2016,Summer,2,0,0,2
AZE,1996,Summer,0,0,1,1
AZE,2000,Summer,1,2,0,3
AZE,2004,Summer,4,1,0,5
AZE,2008,Summer,4,1,2,7
AZE,2012,Summer,6,2,2,10
AZE,2016,Summer,10,1,7,18
BAH,1956,Summer,2,0,0,2
BAH,1964,Summer,0,2,0,2
BAH,1992,Summer,1,0,0,1
BAH,1996,Summer,0,0,5,5
BAH,2000,Summer,5,6,0,11
BAH,2004,Summer,1,1,0,2
BAH,2008,Summer,1,0,6,7
BAH,2012,Summer,0,4,0,4
BAH,2016,Summer,5,1,0,6
BAR,2000,Summer,1,0,0,1
BDI,1996,Summer,0,1,0,1
BDI,2016,Summer,0,0,1,1
BEL,1900,Summer,13,6,24,43
BEL,1906,Summer,6,2,3,11
BEL,1908,Summer,8,1,24,33
BEL,1912,Summer,11,7,1,19
BEL,1920,Summer,66,57,65,188
BEL,1924,Summer,6,3,30,39
BEL,1924,Winter,5,0,0,5
BEL,1928,Summer,4,0,1,5
BEL,1928,Winter,1,0,0,1
BEL,1932,Summer,1,0,0,1
BEL,1936,Summer,14,0,0,14
BEL,1948,Summer,8,5,2,15
BEL,1948,Winter,0,2,4,6
BEL,1952,Summer,0,5,3,8
BEL,1956,Summer,0,0,2,2
BEL,1960,Summer,2,0,2,4
BEL,1964,Summer,1,2,0,3
BEL,1968,Summer,2,0,1,3
BEL,1972,Summer,0,0,2,2
BEL,1976,Summer,6,0,3,9
BEL,1980,Summer,0,1,0,1
BEL,1984,Summer,2,1,2,5
BEL,1988,Summer,2,0,0,2
BEL,1992,Summer,2,0,1,3
BEL,1996,Summer,2,2,2,6
BEL,1998,Winter,1,0,0,1
BEL,2000,Summer,4,0,3,7
BEL,2004,Summer,2,1,0,3
BEL,2008,Summer,0,1,4,5
BEL,2012,Summer,2,0,1,3
BEL,2016,Summer,2,2,17,21
BER,1976,Summer,1,0,0,1
BLR,1994,Winter,0,0,2,2
BLR,1996,Summer,16,1,6,23
BLR,1998,Winter,2,0,0,2
BLR,2000,Summer,11,3,8,22
BLR,2002,Winter,1,0,0,1
BLR,2004,Summer,8,2,5,15
BLR,2006,Winter,0,0,1,1
BLR,2008,Summer,16,8,5,29
BLR,2010,Winter,1,1,1,3
BLR,2012,Summer,8,3,12,23
BLR,2014,Winter,1,5,0,6
BLR,2016,Summer,7,1,4,12
BOH,1900,Summer,2,0,1,3
BOH,1906,Summer,3,0,0,3
BOH,1908,Summer,6,0,0,6
BOT,2012,Summer,0,0,1,1
BRA,1920,Summer,5,1,1,7
BRA,1948,Summer,10,0,0,10
BRA,1952,Summer,2,1,0,3
BRA,1956,Summer,0,1,0,1
BRA,1960,Summer,13,0,0,13
BRA,1964,Summer,12,0,0,12
BRA,1968,Summer,3,0,1,4
BRA,1972,Summer,2,0,0,2
BRA,1976,Summer,3,0,0,3
BRA,1980,Summer,5,4,0,9
BRA,1984,Summer,2,1,33,36
BRA,1988,Summer,5,1,17,23
BRA,1992,Summer,0,13,1,14
BRA,1996,Summer,43,5,15,63
BRA,2000,Summer,36,0,12,48
BRA,2004,Summer,3,18,19,40
BRA,2008,Summer,30,14,34,78
BRA,2012,Summer,11,14,34,59
BRA,2016,Summer,6,36,8,50
BRN,2012,Summer,1,0,0,1
BRN,2016,Summer,0,1,1,2
BUL,1952,Summer,1,0,0,1
BUL,1956,Summer,14,1,3,18
BUL,1960,Summer,3,1,3,7
BUL,1964,Summer,2,3,5,10
BUL,1968,Summer,3,2,21,26
BUL,1972,Summer,6,6,10,22
BUL,1976,Summer,18,8,13,39
BUL,1980,Summer,38,8,44,90
BUL,1980,Winter,1,0,0,1
BUL,1988,Summer,17,10,14,41
BUL,1992,Summer,7,3,7,17
BUL,1996,Summer,6,3,12,21
BUL,1998,Winter,0,1,0,1
BUL,2000,Summer,2,5,6,13
BUL,2002,Winter,2,0,1,3
BUL,2004,Summer,14,2,1,17
BUL,2006,Winter,0,0,1,1
BUL,2008,Summer,3,1,1,5
BUL,2012,Summer,1,0,1,2
BUL,2016,Summer,6,0,1,7
CAN,1900,Summer,1,1,0,2
CAN,1904,Summer,12,27,9,48
CAN,1906,Summer,0,1,1,2
CAN,1908,Summer,30,14,8,52
CAN,1912,Summer,3,3,2,8
CAN,1920,Summer,3,10,3,16
CAN,1924,Summer,1,0,19,20
CAN,1924,Winter,0,9,0,9
CAN,1928,Summer,21,7,5,33
CAN,1928,Winter,0,12,0,12
CAN,1932,Summer,24,2,13,39
CAN,1932,Winter,5,14,1,20
CAN,1936,Summer,9,1,12,22
CAN,1936,Winter,0,0,13,13
CAN,1948,Summer,5,0,2,7
CAN,1948,Winter,2,13,0,15
CAN,1952,Summer,0,1,3,4
CAN,1952,Winter,1,16,0,17
CAN,1956,Summer,5,5,9,19
CAN,1956,Winter,18,0,2,20
CAN,1960,Summer,0,0,9,9
CAN,1960,Winter,1,3,17,21
CAN,1964,Summer,1,2,2,5
CAN,1964,Winter,1,4,2,7
CAN,1968,Summer,4,3,3,10
CAN,1968,Winter,18,1,1,20
CAN,1972,Summer,9,0,2,11
CAN,1972,Winter,0,0,1,1
CAN,1976,Summer,14,0,9,23
CAN,1976,Winter,1,1,1,3
CAN,1980,Winter,1,0,1,2
CAN,1984,Summer,32,19,36,87
CAN,1984,Winter,1,2,1,4
CAN,1988,Summer,14,4,5,23
CAN,1988,Winter,4,0,2,6
CAN,1992,Summer,12,27,5,44
CAN,1992,Winter,3,5,28,36
CAN,1994,Winter,5,3,29,37
CAN,1996,Summer,12,8,30,50
CAN,1998,Winter,7,14,28,49
CAN,2000,Summer,23,4,4,31
CAN,2002,Winter,15,52,7,74
CAN,2004,Summer,4,3,10,17
CAN,2006,Winter,11,30,28,69
CAN,2008,Summer,11,11,13,35
CAN,2010,Winter,8,67,15,90
CAN,2012,Summer,33,1,21,55
CAN,2014,Winter,5,59,22,86
CAN,2016,Summer,61,4,4,69
CHI,1928,Summer,0,0,1,1
CHI,1952,Summer,0,0,4,4
CHI,1956,Summer,2,0,2,4
CHI,1988,Summer,0,0,1,1
CHI,2000,Summer,17,0,0,17
CHI,2004,Summer,1,3,0,4
CHI,2008,Summer,0,0,1,1
CHN,1984,Summer,37,24,13,74
CHN,1988,Summer,30,6,16,52
CHN,1992,Summer,19,18,45,82
CHN,1992,Winter,0,0,3,3
CHN,1994,Winter,2,0,1,3
CHN,1996,Summer,17,19,70,106
CHN,1998,Winter,5,0,9,14
CHN,2000,Summer,17,39,23,79
CHN,2002,Winter,9,2,5,16
CHN,2004,Summer,15,52,27,94
CHN,2006,Winter,6,2,5,13
CHN,2008,Summer,57,74,53,184
CHN,2010,Winter,7,9,3,19
CHN,2012,Summer,29,56,40,125
CHN,2014,Winter,5,3,4,12
CHN,2016,Summer,37,46,30,113
CIV,1984,Summer,0,0,1,1
CIV,2016,Summer,1,1,0,2
CMR,1968,Summer,0,0,1,1
CMR,1984,Summer,1,0,0,1
CMR,2000,Summer,0,18,0,18
CMR,2004,Summer,0,1,0,1
CMR,2008,Summer,0,1,0,1
COL,1900,Summer,0,0,1,1
COL,1972,Summer,2,0,1,3
COL,1984,Summer,0,0,1,1
COL,1988,Summer,1,0,0,1
COL,1992,Summer,1,0,0,1
COL,2000,Summer,0,1,0,1
COL,2004,Summer,2,0,0,2
COL,2008,Summer,1,0,1,2
COL,2012,Summer,4,1,3,8
COL,2016,Summer,3,3,2,8
CRC,1988,Summer,0,0,1,1
CRC,1996,Summer,0,1,0,1
CRC,2000,Summer,2,0,0,2
CRO,1992,Summer,3,0,12,15
CRO,1996,Summer,0,16,12,28
CRO,2000,Summer,9,1,0,10
CRO,2002,Winter,0,3,1,4
CRO,2004,Summer,3,15,3,21
CRO,2006,Winter,0,1,2,3
CRO,2008,Summer,3,0,2,5
CRO,2010,Winter,1,0,2,3
CRO,2012,Summer,16,15,4,35
CRO,2014,Winter,0,0,1,1
CRO,2016,Summer,2,7,15,24
CUB,1900,Summer,0,1,1,2
CUB,1904,Summer,0,5,0,5
CUB,1948,Summer,0,0,2,2
CUB,1964,Summer,0,0,1,1
CUB,1968,Summer,0,0,10,10
CUB,1972,Summer,18,3,1,22
CUB,1976,Summer,14,6,4,24
CUB,1980,Summer,5,8,7,20
CUB,1992,Summer,14,42,13,69
CUB,1996,Summer,10,37,8,55
CUB,2000,Summer,12,18,35,65
CUB,2004,Summer,22,32,8,62
CUB,2008,Summer,11,2,34,47
CUB,2012,Summer,6,5,3,14
CUB,2016,Summer,4,5,2,11
CYP,2012,Summer,0,0,1,1
CZE,1996,Summer,4,4,5,13
CZE,1998,Winter,1,21,1,23
CZE,2000,Summer,4,2,3,9
CZE,2002,Winter,0,1,2,3
CZE,2004,Summer,6,1,6,13
CZE,2006,Winter,24,1,2,27
CZE,2008,Summer,0,3,4,7
CZE,2010,Winter,7,2,0,9
CZE,2012,Summer,6,4,4,14
CZE,2014,Winter,2,2,7,11
CZE,2016,Summer,12,1,2,15
DEN,1896,Summer,3,1,2,6
DEN,1900,Summer,2,4,3,9
DEN,1906,Summer,1,14,19,34
DEN,1908,Summer,3,0,14,17
DEN,1912,Summer,33,5,49,87
DEN,1920,Summer,1,26,44,71
DEN,1924,Summer,3,2,9,14
DEN,1928,Summer,4,6,5,15
DEN,1932,Summer,4,0,7,11
DEN,1936,Summer,3,0,3,6
DEN,1948,Summer,27,7,17,51
DEN,1952,Summer,5,3,1,9
DEN,1956,Summer,1,1,4,6
DEN,1960,Summer,4,2,17,23
DEN,1964,Summer,4,7,1,12
DEN,1968,Summer,6,5,6,17
DEN,1972,Summer,0,1,0,1
DEN,1976,Summer,5,3,0,8
DEN,1980,Summer,2,4,2,8
DEN,1984,Summer,10,0,3,13
DEN,1988,Summer,3,3,1,7
DEN,1992,Summer,9,3,2,14
DEN,1996,Summer,1,21,1,23
DEN,1998,Winter,0,0,5,5
DEN,2000,Summer,4,18,3,25
DEN,2004,Summer,9,19,1,29
DEN,2008,Summer,6,6,7,19
DEN,2012,Summer,8,3,5,16
DEN,2016,Summer,16,15,10,41
DJI,1988,Summer,1,0,0,1
DOM,1984,Summer,1,0,0,1
DOM,2004,Summer,0,1,0,1
DOM,2008,Summer,0,1,1,2
DOM,2012,Summer,0,1,1,2
DOM,2016,Summer,1,0,0,1
ECU,1996,Summer,0,1,0,1
ECU,2008,Summer,0,0,1,1
EGY,1928,Summer,1,2,1,4
EGY,1936,Summer,2,2,1,5
EGY,1948,Summer,1,2,2,5
EGY,1952,Summer,1,0,0,1
EGY,1984,Summer,0,0,1,1
EGY,2004,Summer,3,1,1,5
EGY,2008,Summer,1,0,0,1
EGY,2012,Summer,0,0,2,2
EGY,2016,Summer,3,0,0,3
ERI,2004,Summer,1,0,0,1
ESP,1900,Summer,0,2,0,2
ESP,1920,Summer,0,0,23,23
ESP,1928,Summer,0,3,0,3
ESP,1932,Summer,1,0,0,1
ESP,1948,Summer,0,0,3,3
ESP,1952,Summer,0,0,1,1
ESP,1960,Summer,14,0,0,14
ESP,1972,Summer,1,0,0,1
ESP,1972,Winter,0,1,0,1
ESP,1976,Summer,0,0,6,6
ESP,1980,Summer,3,2,19,24
ESP,1984,Summer,3,2,14,19
ESP,1988,Summer,2,1,2,5
ESP,1992,Summer,2,48,19,69
ESP,1992,Winter,1,0,0,1
ESP,1996,Summer,22,23,21,66
ESP,2000,Summer,20,3,19,42
ESP,2004,Summer,9,4,17,30
ESP,2008,Summer,16,7,47,70
ESP,2012,Summer,25,5,33,63
ESP,2016,Summer,17,9,19,45
EST,1920,Summer,0,1,2,3
EST,1924,Summer,4,1,1,6
EST,1928,Summer,6,2,1,9
EST,1936,Summer,3,2,2,7
EST,1992,Summer,2,1,0,3
EST,2000,Summer,2,1,0,3
EST,2002,Winter,1,1,1,3
EST,2004,Summer,2,0,1,3
EST,2006,Winter,0,3,0,3
EST,2008,Summer,0,1,2,3
EST,2010,Winter,0,0,1,1
EST,2012,Summer,1,0,1,2
EST,2016,Summer,4,0,0,4
ETH,1960,Summer,0,1,0,1
ETH,1964,Summer,0,1,0,1
ETH,1968,Summer,0,1,1,2
ETH,1972,Summer,2,0,0,2
ETH,1980,Summer,2,2,0,4
ETH,1992,Summer,2,1,0,3
ETH,1996,Summer,1,2,0,3
ETH,2000,Summer,3,4,1,8
ETH,2004,Summer,2,2,3,7
ETH,2008,Summer,2,4,1,7
ETH,2012,Summer,3,3,1,7
ETH,2016,Summer,5,1,2,8
EUN,1992,Summer,67,92,61,220
EUN,1992,Winter,14,35,10,59
FIJ,2016,Summer,0,13,0,13
FIN,1906,Summer,1,2,1,4
FIN,1908,Summer,28,1,1,30
FIN,1912,Summer,22,9,40,71
FIN,1920,Summer,17,21,14,52
FIN,1924,Summer,15,24,13,52
FIN,1924,Winter,3,4,8,15
FIN,1928,Summer,9,8,8,25
FIN,1928,Winter,1,2,1,4
FIN,1932,Summer,16,5,8,29
FIN,1932,Winter,1,1,1,3
FIN,1936,Summer,13,8,6,27
FIN,1936,Winter,3,4,2,9
FIN,1948,Summer,8,17,8,33
FIN,1948,Winter,2,1,6,9
FIN,1952,Summer,29,8,3,40
FIN,1952,Winter,2,6,4,12
FIN,1956,Summer,22,3,1,26
FIN,1956,Winter,1,5,6,12
FIN,1960,Summer,4,1,1,6
FIN,1960,Winter,5,5,3,13
FIN,1964,Summer,2,3,0,5
FIN,1964,Winter,5,3,7,15
FIN,1968,Summer,1,1,2,4
FIN,1968,Winter,5,1,2,8
FIN,1972,Summer,6,3,1,10
FIN,1972,Winter,1,0,9,10
FIN,1976,Summer,0,4,2,6
FIN,1976,Winter,1,5,10,16
FIN,1980,Summer,5,3,1,9
FIN,1980,Winter,6,1,5,12
FIN,1984,Summer,6,4,2,12
FIN,1984,Winter,12,4,3,19
FIN,1988,Summer,2,1,1,4
FIN,1988,Winter,5,7,22,34
FIN,1992,Summer,2,1,4,7
FIN,1992,Winter,6,6,1,13
FIN,1994,Winter,29,0,1,30
FIN,1996,Summer,1,1,2,4
FIN,1998,Winter,49,2,7,58
FIN,2000,Summer,1,3,1,5
FIN,2002,Winter,1,7,5,13
FIN,2004,Summer,0,0,2,2
FIN,2006,Winter,7,0,34,41
FIN,2008,Summer,2,1,2,5
FIN,2010,Winter,46,0,1,47
FIN,2012,Summer,4,0,1,5
FIN,2014,Winter,24,2,7,33
FIN,2016,Summer,1,0,0,1
FRA,1896,Summer,2,5,4,11
FRA,1900,Summer,82,52,101,235
FRA,1904,Summer,0,0,2,2
FRA,1906,Summer,28,20,16,64
FRA,1908,Summer,23,12,5,40
FRA,1912,Summer,5,10,11,26
FRA,1920,Summer,57,13,71,141
FRA,1924,Summer,22,37,51,110
FRA,1924,Winter,10,0,0,10
FRA,1928,Summer,14,12,24,50
FRA,1928,Winter,0,2,0,2
FRA,1932,Summer,6,26,8,40
FRA,1932,Winter,0,2,0,2
FRA,1936,Summer,18,13,13,44
FRA,1936,Winter,1,0,0,1
FRA,1948,Summer,24,26,22,72
FRA,1948,Winter,2,2,1,5
FRA,1952,Summer,17,14,9,40
FRA,1952,Winter,1,0,0,1
FRA,1956,Summer,13,7,13,33
FRA,1960,Summer,6,0,6,12
FRA,1960,Winter,2,1,0,3
FRA,1964,Summer,17,1,13,31
FRA,1964,Winter,0,3,4,7
FRA,1968,Summer,10,12,5,27
FRA,1968,Winter,2,4,3,9
FRA,1972,Summer,15,2,5,22
FRA,1972,Winter,2,0,1,3
FRA,1976,Summer,8,5,7,20
FRA,1976,Winter,1,0,0,1
FRA,1980,Summer,6,18,5,29
FRA,1980,Winter,1,0,0,1
FRA,1984,Summer,31,20,16,67
FRA,1984,Winter,2,0,1,3
FRA,1988,Summer,13,12,4,29
FRA,1988,Winter,1,1,0,2
FRA,1992,Summer,43,9,5,57
FRA,1992,Winter,1,5,6,12
FRA,1994,Winter,10,0,1,11
FRA,1996,Summer,20,21,10,51
FRA,1998,Winter,12,2,1,15
FRA,2000,Summer,14,22,30,66
FRA,2002,Winter,5,5,5,15
FRA,2004,Summer,22,21,10,53
FRA,2006,Winter,10,3,2,15
FRA,2008,Summer,28,25,24,77
FRA,2010,Winter,6,2,6,14
FRA,2012,Summer,22,30,30,82
FRA,2014,Winter,10,4,4,18
FRA,2016,Summer,21,20,55,96
FRG,1968,Summer,18,17,16,51
FRG,1968,Winter,5,2,3,10
FRG,1972,Summer,39,44,19,102
FRG,1972,Winter,4,4,2,10
FRG,1976,Summer,32,21,25,78
FRG,1976,Winter,23,2,7,32
FRG,1980,Winter,6,0,2,8
FRG,1984,Summer,53,30,75,158
FRG,1984,Winter,4,3,1,8
FRG,1988,Summer,46,32,37,115
FRG,1988,Winter,3,4,7,14
GAB,2012,Summer,0,0,1,1
GBR,1896,Summer,3,3,3,9
GBR,1900,Summer,15,59,34,108
GBR,1904,Summer,0,1,1,2
GBR,1906,Summer,8,9,22,39
GBR,1908,Summer,90,147,131,368
GBR,1912,Summer,59,47,64,170
GBR,1920,Summer,17,52,42,111
GBR,1924,Summer,19,15,30,64
GBR,1924,Winter,11,16,4,31
GBR,1928,Summer,24,7,27,58
GBR,1928,Winter,1,0,0,1
GBR,1932,Summer,14,9,12,35
GBR,1936,Summer,8,12,16,36
GBR,1936,Winter,4,12,1,17
GBR,1948,Summer,12,7,42,61
GBR,1948,Winter,2,0,0,2
GBR,1952,Summer,26,3,2,31
GBR,1952,Winter,0,1,0,1
GBR,1956,Summer,22,8,16,46
GBR,1960,Summer,15,2,11,28
GBR,1964,Summer,5,4,19,28
GBR,1964,Winter,0,2,0,2
GBR,1968,Summer,5,9,5,19
GBR,1972,Summer,12,8,9,29
GBR,1976,Summer,11,6,15,32
GBR,1976,Winter,0,1,0,1
GBR,1980,Summer,24,5,18,47
GBR,1980,Winter,0,1,0,1
GBR,1984,Summer,42,9,20,71
GBR,1984,Winter,0,2,0,2
GBR,1988,Summer,15,22,17,54
GBR,1992,Summer,39,8,3,50
GBR,1994,Winter,3,0,0,3
GBR,1996,Summer,9,2,15,26
GBR,1998,Winter,4,0,0,4
GBR,2000,Summer,12,22,20,54
GBR,2002,Winter,1,5,0,6
GBR,2004,Summer,15,17,25,57
GBR,2006,Winter,0,0,1,1
GBR,2008,Summer,25,31,25,81
GBR,2010,Winter,0,1,0,1
GBR,2012,Summer,48,48,30,126
GBR,2014,Winter,5,1,4,10
GBR,2016,Summer,26,64,55,145
GDR,1968,Summer,19,13,20,52
GDR,1968,Winter,2,2,2,6
GDR,1972,Summer,57,30,64,151
GDR,1972,Winter,12,5,3,20
GDR,1976,Summer,42,102,51,195
GDR,1976,Winter,14,12,6,32
GDR,1980,Summer,61,115,88,264
GDR,1980,Winter,12,16,11,39
GDR,1984,Winter,7,13,13,33
GDR,1988,Summer,48,79,54,181
GDR,1988,Winter,7,10,15,32
GEO,1996,Summer,2,0,0,2
GEO,2000,Summer,6,0,0,6
GEO,2004,Summer,0,2,2,4
GEO,2008,Summer,3,3,0,6
GEO,2012,Summer,3,1,3,7
GEO,2016,Summer,4,2,1,7
GER,1896,Summer,2,25,5,32
GER,1900,Summer,11,14,20,45
GER,1904,Summer,7,4,5,16
GER,1906,Summer,6,14,10,30
GER,1908,Summer,6,4,11,21
GER,1912,Summer,23,11,19,53
GER,1928,Summer,41,21,15,77
GER,1928,Winter,5,0,0,5
GER,1932,Summer,7,10,26,43
GER,1932,Winter,14,0,0,14
GER,1936,Summer,61,93,70,224
GER,1936,Winter,0,4,3,7
GER,1952,Summer,26,0,14,40
GER,1952,Winter,2,8,2,12
GER,1956,Summer,23,9,20,52
GER,1956,Winter,1,1,0,2
GER,1960,Summer,22,34,33,89
GER,1960,Winter,1,4,4,9
GER,1964,Summer,50,22,44,116
GER,1964,Winter,3,3,4,10
GER,1992,Summer,60,81,57,198
GER,1992,Winter,7,14,17,38
GER,1994,Winter,12,18,10,40
GER,1996,Summer,47,42,35,124
GER,1998,Winter,10,22,12,44
GER,2000,Summer,64,31,23,118
GER,2002,Winter,12,26,23,61
GER,2004,Summer,63,41,45,149
GER,2006,Winter,6,23,25,54
GER,2008,Summer,41,42,16,99
GER,2010,Winter,15,15,24,54
GER,2012,Summer,22,45,27,94
GER,2014,Winter,9,15,12,36
GER,2016,Summer,67,49,43,159
GHA,1960,Summer,0,0,1,1
GHA,1964,Summer,1,0,0,1
GHA,1972,Summer,1,0,0,1
GHA,1992,Summer,20,0,0,20
GRE,1896,Summer,20,10,18,48
GRE,1904,Summer,1,1,0,2
GRE,1906,Summer,30,24,48,102
GRE,1908,Summer,1,0,3,4
GRE,1912,Summer,1,1,0,2
GRE,1920,Summer,0,0,5,5
GRE,1924,Summer,0,1,0,1
GRE,1956,Summer,1,0,0,1
GRE,1960,Summer,0,3,0,3
GRE,1968,Summer,1,0,0,1
GRE,1972,Summer,0,0,2,2
GRE,1980,Summer,4,1,0,5
GRE,1984,Summer,1,0,1,2
GRE,1988,Summer,1,0,0,1
GRE,1992,Summer,0,2,0,2
GRE,1996,Summer,0,4,4,8
GRE,2000,Summer,8,4,6,18
GRE,2004,Summer,5,8,18,31
GRE,2008,Summer,4,0,3,7
GRE,2012,Summer,3,0,0,3
GRE,2016,Summer,3,3,1,7
GRN,2012,Summer,0,1,0,1
GRN,2016,Summer,0,0,1,1
GUA,2012,Summer,0,0,1,1
GUY,1980,Summer,1,0,0,1
HAI,1900,Summer,0,1,0,1
HAI,1924,Summer,5,0,0,5
HAI,1928,Summer,0,0,1,1
HKG,1996,Summer,0,1,0,1
HKG,2004,Summer,0,0,2,2
HKG,2012,Summer,1,0,0,1
HUN,1896,Summer,3,2,1,6
HUN,1900,Summer,2,1,2,5
HUN,1904,Summer,1,2,1,4
HUN,1906,Summer,3,5,5,13
HUN,1908,Summer,6,7,7,20
HUN,1912,Summer,3,10,17,30
HUN,1924,Summer,8,2,12,22
HUN,1928,Summer,0,10,11,21
HUN,1932,Summer,8,20,5,33
HUN,1932,Winter,2,0,0,2
HUN,1936,Summer,15,25,1,41
HUN,1936,Winter,2,0,0,2
HUN,1948,Summer,22,15,25,62
HUN,1948,Winter,0,0,2,2
HUN,1952,Summer,32,53,17,102
HUN,1952,Winter,2,0,0,2
HUN,1956,Summer,14,30,20,64
HUN,1956,Winter,2,0,0,2
HUN,1960,Summer,37,13,16,66
HUN,1964,Summer,7,42,7,56
HUN,1968,Summer,29,32,20,81
HUN,1972,Summer,25,10,46,81
HUN,1976,Summer,35,14,6,55
HUN,1980,Summer,40,8,13,61
HUN,1980,Winter,0,0,2,2
HUN,1988,Summer,15,20,9,44
HUN,1992,Summer,8,14,23,45
HUN,1996,Summer,26,8,9,43
HUN,2000,Summer,4,25,24,53
HUN,2004,Summer,4,24,12,40
HUN,2008,Summer,3,16,8,27
HUN,2012,Summer,6,12,8,26
HUN,2016,Summer,7,12,3,22
INA,1988,Summer,0,0,3,3
INA,1992,Summer,1,2,3,6
INA,1996,Summer,3,2,1,6
INA,2000,Summer,2,2,4,8
INA,2004,Summer,3,1,1,5
INA,2008,Summer,3,2,2,7
INA,2012,Summer,1,0,1,2
INA,2016,Summer,0,2,2,4
IND,1900,Summer,0,0,2,2
IND,1924,Winter,0,7,0,7
IND,1928,Summer,0,14,0,14
IND,1932,Summer,0,15,0,15
IND,1936,Summer,0,19,0,19
IND,1948,Summer,0,20,0,20
IND,1952,Summer,1,14,0,15
IND,1956,Summer,0,17,0,17
IND,1960,Summer,0,0,13,13
IND,1964,Summer,0,15,0,15
IND,1968,Summer,16,0,0,16
IND,1972,Summer,14,0,0,14
IND,1980,Summer,0,16,0,16
IND,1996,Summer,1,0,0,1
IND,2000,Summer,1,0,0,1
IND,2004,Summer,0,0,1,1
IND,2008,Summer,2,1,0,3
IND,2012,Summer,4,0,2,6
IND,2016,Summer,1,0,1,2
IOA,1992,Summer,2,0,1,3
IOA,2016,Summer,1,1,0,2
IRI,1948,Summer,1,0,0,1
IRI,1952,Summer,4,0,3,7
IRI,1956,Summer,1,2,2,5
IRI,1960,Summer,3,0,1,4
IRI,1964,Summer,2,0,0,2
IRI,1968,Summer,2,2,1,5
IRI,1972,Summer,1,0,2,3
IRI,1976,Summer,1,0,1,2
IRI,1988,Summer,0,0,1,1
IRI,1992,Summer,2,0,1,3
IRI,1996,Summer,1,1,1,3
IRI,2000,Summer,1,3,0,4
IRI,2004,Summer,2,2,2,6
IRI,2008,Summer,1,1,0,2
IRI,2012,Summer,3,4,5,12
IRI,2016,Summer,4,3,1,8
IRL,1924,Summer,1,0,1,2
IRL,1928,Summer,0,1,0,1
IRL,1932,Summer,0,2,0,2
IRL,1948,Summer,1,0,0,1
IRL,1952,Summer,0,0,1,1
IRL,1956,Summer,3,1,1,5
IRL,1964,Summer,1,0,0,1
IRL,1980,Summer,1,0,2,3
IRL,1984,Summer,0,0,1,1
IRL,1992,Summer,0,1,1,2
IRL,1996,Summer,1,3,0,4
IRL,2000,Summer,0,0,1,1
IRL,2008,Summer,2,0,1,3
IRL,2012,Summer,3,1,1,5
IRL,2016,Summer,0,0,3,3
IRQ,1960,Summer,1,0,0,1
ISL,1956,Summer,0,0,1,1
ISL,1984,Summer,1,0,0,1
ISL,2000,Summer,1,0,0,1
ISL,2008,Summer,0,0,14,14
ISR,1992,Summer,1,0,1,2
ISR,1996,Summer,1,0,0,1
ISR,2000,Summer,1,0,0,1
ISR,2004,Summer,1,1,0,2
ISR,2008,Summer,1,0,0,1
ISR,2016,Summer,2,0,0,2
ISV,1988,Summer,0,0,1,1
ITA,1900,Summer,0,3,2,5
ITA,1906,Summer,27,21,8,56
ITA,1908,Summer,0,2,6,8
ITA,1912,Summer,2,22,1,25
ITA,1920,Summer,8,67,9,84
ITA,1924,Summer,21,25,5,51
ITA,1928,Summer,26,24,22,72
ITA,1932,Summer,18,21,38,77
ITA,1936,Summer,5,37,34,76
ITA,1948,Summer,14,21,32,67
ITA,1948,Winter,0,1,0,1
ITA,1952,Summer,15,17,22,54
ITA,1952,Winter,1,1,0,2
ITA,1956,Summer,10,26,11,47
ITA,1956,Winter,0,2,6,8
ITA,1960,Summer,34,36,18,88
ITA,1960,Winter,1,0,0,1
ITA,1964,Summer,9,14,28,51
ITA,1964,Winter,8,0,2,10
ITA,1968,Summer,20,5,8,33
ITA,1968,Winter,0,8,0,8
ITA,1972,Summer,13,9,3,25
ITA,1972,Winter,1,3,5,9
ITA,1976,Summer,4,2,25,31
ITA,1976,Winter,1,1,2,4
ITA,1980,Summer,8,8,21,37
ITA,1980,Winter,0,0,3,3
ITA,1984,Summer,28,29,6,63
ITA,1984,Winter,0,2,0,2
ITA,1988,Summer,8,11,10,29
ITA,1988,Winter,5,2,1,8
ITA,1992,Summer,14,21,10,45
ITA,1992,Winter,8,4,9,21
ITA,1994,Winter,12,14,6,32
ITA,1996,Summer,28,19,24,71
ITA,1998,Winter,5,3,9,17
ITA,2000,Summer,29,22,14,65
ITA,2002,Winter,6,4,11,21
ITA,2004,Summer,39,24,41,104
ITA,2006,Winter,14,11,0,25
ITA,2008,Summer,20,8,14,42
ITA,2010,Winter,3,1,1,5
ITA,2012,Summer,30,16,22,68
ITA,2014,Winter,12,0,2,14
ITA,2016,Summer,24,8,40,72
JAM,1948,Summer,0,1,2,3
JAM,1952,Summer,0,5,3,8
JAM,1968,Summer,0,0,1,1
JAM,1972,Summer,1,0,0,1
JAM,1976,Summer,0,1,1,2
JAM,1980,Summer,3,0,0,3
JAM,1984,Summer,2,0,5,7
JAM,1988,Summer,0,0,7,7
JAM,1992,Summer,1,0,3,4
JAM,1996,Summer,12,1,3,16
JAM,2000,Summer,3,0,20,23
JAM,2004,Summer,6,6,1,13
JAM,2008,Summer,6,5,3,14
JAM,2012,Summer,8,8,9,25
JAM,2016,Summer,2,11,17,30
JOR,2016,Summer,0,1,0,1
JPN,1920,Summer,0,0,3,3
JPN,1924,Summer,1,0,0,1
JPN,1928,Summer,1,2,6,9
JPN,1932,Summer,4,10,17,31
JPN,1936,Summer,10,9,4,23
JPN,1952,Summer,2,1,9,12
JPN,1956,Summer,5,4,15,24
JPN,1956,Winter,0,0,1,1
JPN,1960,Summer,12,9,10,31
JPN,1964,Summer,25,32,5,62
JPN,1968,Summer,22,16,25,63
JPN,1972,Summer,8,29,19,56
JPN,1972,Winter,1,1,1,3
JPN,1976,Summer,10,25,6,41
JPN,1980,Winter,0,0,1,1
JPN,1984,Summer,31,10,8,49
JPN,1984,Winter,0,0,1,1
JPN,1988,Summer,13,4,3,20
JPN,1988,Winter,1,0,0,1
JPN,1992,Summer,36,3,8,47
JPN,1992,Winter,7,3,2,12
JPN,1994,Winter,2,3,5,10
JPN,1996,Summer,13,3,26,42
JPN,1998,Winter,4,8,1,13
JPN,2000,Summer,8,5,31,44
JPN,2002,Winter,1,0,1,2
JPN,2004,Summer,52,21,20,93
JPN,2006,Winter,0,1,0,1
JPN,2008,Summer,13,23,15,51
JPN,2010,Winter,2,0,5,7
JPN,2012,Summer,33,7,44,84
JPN,2014,Winter,6,1,4,11
JPN,2016,Summer,34,17,13,64
KAZ,1994,Winter,0,1,2,3
KAZ,1996,Summer,4,3,4,11
KAZ,1998,Winter,2,0,0,2
KAZ,2000,Summer,0,3,4,7
KAZ,2004,Summer,3,1,4,8
KAZ,2008,Summer,7,2,4,13
KAZ,2010,Winter,0,0,1,1
KAZ,2012,Summer,5,7,1,13
KAZ,2014,Winter,1,0,0,1
KAZ,2016,Summer,10,3,5,18
KEN,1964,Summer,1,0,0,1
KEN,1968,Summer,2,3,7,12
KEN,1972,Summer,4,5,3,12
KEN,1984,Summer,2,1,0,3
KEN,1988,Summer,2,5,2,9
KEN,1992,Summer,2,2,4,8
KEN,1996,Summer,3,1,4,8
KEN,2000,Summer,2,2,3,7
KEN,2004,Summer,2,1,4,7
KEN,2008,Summer,5,6,4,15
KEN,2012,Summer,5,2,4,11
KEN,2016,Summer,1,6,6,13
KGZ,2000,Summer,1,0,0,1
KGZ,2008,Summer,1,0,1,2
KOR,1948,Summer,2,0,0,2
KOR,1952,Summer,2,0,0,2
KOR,1956,Summer,1,0,1,2
KOR,1964,Summer,1,0,2,3
KOR,1968,Summer,1,0,1,2
KOR,1972,Summer,0,0,1,1
KOR,1976,Summer,15,1,1,17
KOR,1984,Summer,7,6,28,41
KOR,1988,Summer,12,28,37,77
KOR,1992,Summer,16,28,5,49
KOR,1992,Winter,1,5,1,7
KOR,1994,Winter,1,7,1,9
KOR,1996,Summer,7,10,49,66
KOR,1998,Winter,2,6,4,12
KOR,2000,Summer,35,12,26,73
KOR,2002,Winter,0,5,2,7
KOR,2004,Summer,10,14,28,52
KOR,2006,Winter,2,14,3,19
KOR,2008,Summer,26,41,11,78
KOR,2010,Winter,2,6,10,18
KOR,2012,Summer,30,18,13,61
KOR,2014,Winter,2,7,5,14
KOR,2016,Summer,10,13,3,26
KOS,2016,Summer,0,1,0,1
KSA,2000,Summer,1,0,1,2
KSA,2012,Summer,4,0,0,4
KUW,2000,Summer,1,0,0,1
KUW,2012,Summer,1,0,0,1
LAT,1932,Summer,0,0,1,1
LAT,1936,Summer,1,0,1,2
LAT,1992,Summer,1,0,2,3
LAT,1996,Summer,0,0,1,1
LAT,2000,Summer,1,1,1,3
LAT,2004,Summer,0,0,4,4
LAT,2006,Winter,1,0,0,1
LAT,2008,Summer,1,1,1,3
LAT,2010,Winter,0,0,3,3
LAT,2012,Summer,2,1,0,3
LAT,2014,Winter,6,0,5,11
LIB,1952,Summer,1,0,1,2
LIB,1972,Summer,0,0,1,1
LIB,1980,Summer,1,0,0,1
LIE,1976,Winter,2,0,0,2
LIE,1980,Winter,0,2,2,4
LIE,1984,Winter,2,0,0,2
LIE,1988,Winter,1,0,0,1
LTU,1992,Summer,12,1,0,13
LTU,1996,Summer,11,0,0,11
LTU,2000,Summer,15,2,0,17
LTU,2004,Summer,0,1,2,3
LTU,2008,Summer,3,0,2,5
LTU,2012,Summer,2,2,1,5
LTU,2016,Summer,5,0,2,7
LUX,1900,Summer,0,1,0,1
LUX,1920,Summer,0,0,1,1
LUX,1924,Summer,0,1,1,2
LUX,1928,Summer,0,1,0,1
LUX,1952,Summer,0,1,0,1
LUX,1992,Winter,0,0,2,2
MAR,1960,Summer,0,0,1,1
MAR,1984,Summer,0,2,0,2
MAR,1988,Summer,2,1,0,3
MAR,1992,Summer,1,1,1,3
MAR,1996,Summer,2,0,0,2
MAR,2000,Summer,4,0,1,5
MAR,2004,Summer,0,2,1,3
MAR,2008,Summer,1,0,1,2
MAR,2012,Summer,1,0,0,1
MAR,2016,Summer,1,0,0,1
MAS,1992,Summer,2,0,0,2
MAS,1996,Summer,1,0,2,3
MAS,2008,Summer,0,0,1,1
MAS,2012,Summer,1,0,1,2
MAS,2016,Summer,1,0,7,8
MDA,1996,Summer,1,0,2,3
MDA,2000,Summer,1,0,1,2
MDA,2008,Summer,1,0,0,1
MDA,2012,Summer,2,0,0,2
MEX,1900,Summer,3,0,0,3
MEX,1932,Summer,0,0,2,2
MEX,1936,Summer,16,0,0,16
MEX,1948,Summer,4,4,1,9
MEX,1952,Summer,0,0,1,1
MEX,1956,Summer,1,1,0,2
MEX,1960,Summer,1,0,0,1
MEX,1964,Summer,1,0,0,1
MEX,1968,Summer,3,3,3,9
MEX,1972,Summer,0,0,1,1
MEX,1976,Summer,1,1,0,2
MEX,1980,Summer,9,0,1,10
MEX,1984,Summer,1,2,3,6
MEX,1988,Summer,2,0,0,2
MEX,1992,Summer,0,0,1,1
MEX,1996,Summer,1,0,0,1
MEX,2000,Summer,3,1,2,6
MEX,2004,Summer,1,0,3,4
MEX,2008,Summer,2,2,0,4
MEX,2012,Summer,3,16,5,24
MEX,2016,Summer,2,0,3,5
MGL,1968,Summer,3,0,1,4
MGL,1972,Summer,0,0,1,1
MGL,1976,Summer,0,0,1,1
MGL,1980,Summer,2,0,2,4
MGL,1988,Summer,1,0,0,1
MGL,1992,Summer,2,0,0,2
MGL,1996,Summer,1,0,0,1
MGL,2004,Summer,1,0,0,1
MGL,2008,Summer,0,2,2,4
MGL,2012,Summer,3,0,2,5
MGL,2016,Summer,1,0,1,2
MKD,2000,Summer,1,0,0,1
MNE,2012,Summer,0,0,14,14
MON,1924,Summer,1,0,0,1
MOZ,1996,Summer,1,0,0,1
MOZ,2000,Summer,0,1,0,1
MRI,2008,Summer,1,0,0,1
NAM,1992,Summer,0,0,2,2
NAM,1996,Summer,0,0,2,2
NED,1900,Summer,16,3,8,27
NED,1906,Summer,5,0,1,6
NED,1908,Summer,16,0,0,16
NED,1912,Summer,26,0,0,26
NED,1920,Summer,25,15,10,50
NED,1924,Summer,18,8,1,27
NED,1928,Summer,8,20,29,57
NED,1932,Summer,1,2,10,13
NED,1936,Summer,21,9,7,37
NED,1948,Summer,32,8,2,42
NED,1952,Summer,0,0,18,18
NED,1952,Winter,0,0,3,3
NED,1960,Summer,2,0,1,3
NED,1960,Winter,1,0,1,2
NED,1964,Summer,16,5,10,31
NED,1964,Winter,0,1,1,2
NED,1968,Summer,1,6,7,14
NED,1968,Winter,3,3,3,9
NED,1972,Summer,2,3,1,6
NED,1972,Winter,2,4,3,9
NED,1976,Summer,12,0,2,14
NED,1976,Winter,3,1,2,6
NED,1980,Summer,5,0,1,6
NED,1980,Winter,1,1,2,4
NED,1984,Summer,14,20,7,41
NED,1988,Summer,36,3,6,45
NED,1988,Winter,2,3,2,7
NED,1992,Summer,8,5,20,33
NED,1992,Winter,2,1,1,4
NED,1994,Winter,3,0,1,4
NED,1996,Summer,26,38,9,73
NED,1998,Winter,2,5,4,11
NED,2000,Summer,23,27,29,79
NED,2002,Winter,0,3,5,8
NED,2004,Summer,22,4,51,77
NED,2006,Winter,8,3,2,13
NED,2008,Summer,4,39,18,61
NED,2010,Winter,6,4,1,11
NED,2012,Summer,19,21,29,69
NED,2014,Winter,9,13,7,29
NED,2016,Summer,13,9,25,47
NEP,1924,Winter,0,1,0,1
NGR,1964,Summer,1,0,0,1
NGR,1972,Summer,1,0,0,1
NGR,1984,Summer,4,0,1,5
NGR,1992,Summer,4,0,7,11
NGR,1996,Summer,3,17,4,24
NGR,2000,Summer,0,6,2,8
NGR,2004,Summer,8,0,0,8
NGR,2008,Summer,7,0,16,23
NGR,2016,Summer,18,0,0,18
NIG,1972,Summer,1,0,0,1
NIG,2016,Summer,0,0,1,1
NOR,1900,Summer,3,0,6,9
NOR,1904,Summer,0,2,0,2
NOR,1906,Summer,0,20,5,25
NOR,1908,Summer,3,7,32,42
NOR,1912,Summer,34,40,6,80
NOR,1920,Summer,27,58,52,137
NOR,1924,Summer,3,14,5,22
NOR,1924,Winter,6,4,7,17
NOR,1928,Summer,1,4,4,9
NOR,1928,Winter,5,6,4,15
NOR,1932,Winter,3,3,4,10
NOR,1936,Summer,15,1,12,28
NOR,1936,Winter,3,7,8,18
NOR,1948,Summer,11,3,4,18
NOR,1948,Winter,6,4,3,13
NOR,1952,Summer,0,5,8,13
NOR,1952,Winter,6,7,6,19
NOR,1956,Summer,2,1,0,3
NOR,1956,Winter,1,2,1,4
NOR,1960,Summer,0,2,0,2
NOR,1960,Winter,0,3,6,9
NOR,1964,Winter,6,3,6,15
NOR,1968,Summer,0,4,2,6
NOR,1968,Winter,2,11,9,22
NOR,1972,Summer,4,2,2,8
NOR,1972,Winter,7,2,8,17
NOR,1976,Summer,0,2,4,6
NOR,1976,Winter,1,3,6,10
NOR,1980,Winter,9,1,5,15
NOR,1984,Summer,3,0,1,4
NOR,1984,Winter,4,6,5,15
NOR,1988,Summer,0,2,20,22
NOR,1988,Winter,5,0,6,11
NOR,1992,Summer,1,2,20,23
NOR,1992,Winter,5,9,10,24
NOR,1994,Winter,5,8,17,30
NOR,1996,Summer,18,2,3,23
NOR,1998,Winter,12,13,15,40
NOR,2000,Summer,19,20,4,43
NOR,2002,Winter,7,23,11,41
NOR,2004,Summer,2,5,0,7
NOR,2006,Winter,12,2,9,23
NOR,2008,Summer,1,16,5,22
NOR,2010,Winter,9,16,14,39
NOR,2012,Summer,1,15,1,17
NOR,2014,Winter,13,18,5,36
NOR,2016,Summer,19,0,0,19
NZL,1900,Summer,0,1,0,1
NZL,1920,Summer,1,0,0,1
NZL,1924,Summer,1,0,0,1
NZL,1928,Summer,0,1,0,1
NZL,1932,Summer,0,0,2,2
NZL,1936,Summer,0,1,0,1
NZL,1952,Summer,2,1,0,3
NZL,1956,Summer,0,3,0,3
NZL,1960,Summer,1,2,0,3
NZL,1964,Summer,2,4,0,6
NZL,1968,Summer,2,5,0,7
NZL,1972,Summer,1,9,4,14
NZL,1976,Summer,9,15,1,25
NZL,1984,Summer,6,16,1,23
NZL,1988,Summer,16,4,4,24
NZL,1992,Summer,5,1,9,15
NZL,1992,Winter,0,0,1,1
NZL,1996,Summer,4,3,2,9
NZL,2000,Summer,3,1,0,4
NZL,2004,Summer,0,4,2,6
NZL,2008,Summer,9,4,2,15
NZL,2012,Summer,15,9,3,27
NZL,2016,Summer,5,6,25,36
PAK,1956,Summer,0,0,14,14
PAK,1960,Summer,1,13,0,14
PAK,1964,Summer,0,0,16,16
PAK,1968,Summer,0,13,0,13
PAK,1972,Summer,0,0,15,15
PAK,1976,Summer,16,0,0,16
PAK,1984,Summer,0,16,0,16
PAK,1988,Summer,1,0,0,1
PAK,1992,Summer,16,0,0,16
PAN,1948,Summer,2,0,0,2
PAN,2008,Summer,0,1,0,1
PAR,2004,Summer,0,0,17,17
PER,1948,Summer,0,1,0,1
PER,1984,Summer,0,0,1,1
PER,1988,Summer,0,0,12,12
PER,1992,Summer,0,0,1,1
PHI,1928,Summer,1,0,0,1
PHI,1932,Summer,3,0,0,3
PHI,1936,Summer,1,0,0,1
PHI,1964,Summer,0,0,1,1
PHI,1988,Summer,1,0,0,1
PHI,1992,Summer,1,0,0,1
PHI,1996,Summer,0,0,1,1
PHI,2016,Summer,0,0,1,1
POL,1924,Summer,1,0,4,5
POL,1928,Summer,15,2,3,20
POL,1932,Summer,14,3,4,21
POL,1936,Summer,6,0,6,12
POL,1948,Summer,1,1,0,2
POL,1952,Summer,1,1,2,4
POL,1956,Summer,9,1,9,19
POL,1956,Winter,1,0,0,1
POL,1960,Summer,15,4,11,30
POL,1960,Winter,1,0,1,2
POL,1964,Summer,23,10,13,46
POL,1968,Summer,30,5,2,37
POL,1972,Summer,11,27,8,46
POL,1972,Winter,0,1,0,1
POL,1976,Summer,26,18,29,73
POL,1980,Summer,22,3,25,50
POL,1988,Summer,10,2,9,21
POL,1992,Summer,19,5,22,46
POL,1996,Summer,7,7,8,22
POL,2000,Summer,7,7,10,24
POL,2002,Winter,1,0,1,2
POL,2004,Summer,6,4,2,12
POL,2006,Winter,1,0,1,2
POL,2008,Summer,1,6,13,20
POL,2010,Winter,4,1,3,8
POL,2012,Summer,8,2,2,12
POL,2014,Winter,3,4,4,11
POL,2016,Summer,10,3,3,16
POR,1924,Summer,4,0,0,4
POR,1928,Summer,6,0,0,6
POR,1936,Summer,3,0,0,3
POR,1948,Summer,3,0,2,5
POR,1952,Summer,2,0,0,2
POR,1960,Summer,0,0,2,2
POR,1976,Summer,0,0,2,2
POR,1984,Summer,2,1,0,3
POR,1988,Summer,0,1,0,1
POR,1996,Summer,2,1,0,3
POR,2000,Summer,2,0,0,2
POR,2004,Summer,1,0,2,3
POR,2008,Summer,0,1,1,2
POR,2012,Summer,0,0,2,2
POR,2016,Summer,1,0,0,1
PRK,1964,Winter,0,0,1,1
PRK,1972,Summer,13,1,1,15
PRK,1976,Summer,0,1,1,2
PRK,1980,Summer,2,0,3,5
PRK,1992,Summer,6,4,0,10
PRK,1992,Winter,1,0,0,1
PRK,1996,Summer,2,2,1,5
PRK,2000,Summer,3,0,1,4
PRK,2004,Summer,1,0,4,5
PRK,2008,Summer,3,2,1,6
PRK,2012,Summer,2,4,0,6
PRK,2016,Summer,2,2,3,7
PUR,1948,Summer,1,0,0,1
PUR,1976,Summer,1,0,0,1
PUR,1984,Summer,1,0,1,2
PUR,1992,Summer,1,0,0,1
PUR,1996,Summer,1,0,0,1
PUR,2012,Summer,1,0,1,2
PUR,2016,Summer,0,1,0,1
QAT,1992,Summer,1,0,0,1
QAT,2000,Summer,1,0,0,1
QAT,2012,Summer,2,0,0,2
QAT,2016,Summer,0,0,1,1
ROU,1924,Summer,16,0,0,16
ROU,1936,Summer,0,0,1,1
ROU,1952,Summer,2,1,1,4
ROU,1956,Summer,10,6,3,19
ROU,1960,Summer,11,3,1,15
ROU,1964,Summer,10,2,4,16
ROU,1968,Summer,9,5,9,23
ROU,1968,Winter,2,0,0,2
ROU,1972,Summer,27,3,10,40
ROU,1976,Summer,23,4,28,55
ROU,1980,Summer,46,7,15,68
ROU,1984,Summer,35,40,31,106
ROU,1988,Summer,16,8,34,58
ROU,1992,Summer,14,8,31,53
ROU,1996,Summer,15,13,10,38
ROU,2000,Summer,13,27,6,46
ROU,2004,Summer,11,23,5,39
ROU,2008,Summer,16,5,1,22
ROU,2012,Summer,6,2,8,16
ROU,2016,Summer,10,4,2,16
RSA,1908,Summer,0,1,1,2
RSA,1912,Summer,0,5,2,7
RSA,1920,Summer,6,3,12,21
RSA,1924,Summer,1,1,1,3
RSA,1928,Summer,5,1,0,6
RSA,1932,Summer,3,2,0,5
RSA,1936,Summer,0,0,1,1
RSA,1948,Summer,2,2,2,6
RSA,1952,Summer,4,2,8,14
RSA,1956,Summer,7,0,0,7
RSA,1960,Summer,2,0,1,3
RSA,1992,Summer,0,0,3,3
RSA,1996,Summer,1,3,1,5
RSA,2000,Summer,3,0,2,5
RSA,2004,Summer,3,4,3,10
RSA,2008,Summer,0,0,1,1
RSA,2012,Summer,1,6,2,9
RSA,2016,Summer,14,2,7,23
RUS,1908,Summer,0,1,2,3
RUS,1912,Summer,9,0,5,14
RUS,1994,Winter,4,19,13,36
RUS,1996,Summer,34,36,45,115
RUS,1998,Winter,6,14,32,52
RUS,2000,Summer,54,66,67,187
RUS,2002,Winter,27,6,5,38
RUS,2004,Summer,95,48,46,189
RUS,2006,Winter,13,16,12,41
RUS,2008,Summer,53,43,46,142
RUS,2010,Winter,14,6,5,25
RUS,2012,Summer,51,50,39,140
RUS,2014,Winter,13,33,22,68
RUS,2016,Summer,35,52,28,115
SCG,1996,Summer,13,1,12,26
SCG,2000,Summer,13,11,1,25
SCG,2004,Summer,0,0,13,13
SEN,1988,Summer,0,0,1,1
SGP,1960,Summer,0,0,1,1
SGP,2008,Summer,0,0,3,3
SGP,2012,Summer,4,0,0,4
SGP,2016,Summer,0,1,0,1
SLO,1992,Summer,6,0,0,6
SLO,1994,Winter,3,0,0,3
SLO,1996,Summer,0,0,2,2
SLO,2000,Summer,0,3,0,3
SLO,2002,Winter,4,0,0,4
SLO,2004,Summer,3,0,2,5
SLO,2008,Summer,2,1,2,5
SLO,2010,Winter,1,0,2,3
SLO,2012,Summer,3,1,1,5
SLO,2014,Winter,4,2,2,8
SLO,2016,Summer,1,1,2,4
SRB,2008,Summer,14,0,1,15
SRB,2012,Summer,14,1,1,16
SRB,2016,Summer,13,14,27,54
SRI,1948,Summer,0,0,1,1
SRI,2000,Summer,0,0,1,1
SUD,2008,Summer,0,0,1,1
SUI,1896,Summer,0,1,2,3
SUI,1900,Summer,1,16,4,21
SUI,1904,Summer,2,1,0,3
SUI,1906,Summer,1,8,3,12
SUI,1912,Summer,0,2,0,2
SUI,1920,Summer,21,6,2,29
SUI,1924,Summer,21,14,25,60
SUI,1924,Winter,1,8,0,9
SUI,1928,Summer,4,16,10,30
SUI,1928,Winter,12,0,0,12
SUI,1932,Summer,0,0,1,1
SUI,1932,Winter,0,0,2,2
SUI,1936,Summer,24,5,23,52
SUI,1936,Winter,0,4,6,10
SUI,1948,Summer,6,5,25,36
SUI,1948,Winter,19,4,5,28
SUI,1952,Summer,12,2,19,33
SUI,1952,Winter,6,0,0,6
SUI,1956,Summer,3,0,0,3
SUI,1956,Winter,2,6,2,10
SUI,1960,Summer,6,0,6,12
SUI,1960,Winter,0,2,0,2
SUI,1964,Summer,1,1,4,6
SUI,1968,Summer,10,0,3,13
SUI,1968,Winter,7,0,2,9
SUI,1972,Summer,0,0,8,8
SUI,1972,Winter,7,7,3,17
SUI,1976,Summer,6,1,3,10
SUI,1976,Winter,2,1,6,9
SUI,1980,Summer,0,2,0,2
SUI,1980,Winter,3,2,4,9
SUI,1984,Summer,4,0,9,13
SUI,1984,Winter,4,2,2,8
SUI,1988,Summer,2,0,6,8
SUI,1988,Winter,5,8,7,20
SUI,1992,Summer,0,1,0,1
SUI,1992,Winter,5,2,0,7
SUI,1994,Winter,4,4,8,16
SUI,1996,Summer,0,5,6,11
SUI,1998,Winter,3,6,5,14
SUI,2000,Summer,2,1,11,14
SUI,2002,Winter,14,3,7,24
SUI,2004,Summer,4,1,2,7
SUI,2006,Winter,9,5,7,21
SUI,2008,Summer,7,3,1,11
SUI,2010,Winter,6,6,0,12
SUI,2012,Summer,0,2,2,4
SUI,2014,Winter,20,6,4,30
SUI,2016,Summer,2,6,3,11
SUR,1988,Summer,0,1,0,1
SUR,1992,Summer,1,0,0,1
SVK,1996,Summer,1,1,1,3
SVK,2000,Summer,1,2,3,6
SVK,2004,Summer,5,3,2,10
SVK,2006,Winter,0,0,1,1
SVK,2008,Summer,1,4,5,10
SVK,2010,Winter,1,1,1,3
SVK,2012,Summer,4,0,1,5
SVK,2014,Winter,0,1,0,1
SVK,2016,Summer,0,3,5,8
SWE,1900,Summer,1,3,0,4
SWE,1906,Summer,14,2,5,21
SWE,1908,Summer,18,48,18,84
SWE,1912,Summer,25,103,62,190
SWE,1920,Summer,64,52,38,154
SWE,1924,Summer,43,7,22,72
SWE,1924,Winter,0,1,8,9
SWE,1928,Summer,22,7,8,37
SWE,1928,Winter,1,2,13,16
SWE,1932,Summer,12,13,7,32
SWE,1932,Winter,0,1,2,3
SWE,1936,Summer,17,7,11,35
SWE,1936,Winter,6,2,2,10
SWE,1948,Summer,30,30,15,75
SWE,1948,Winter,3,7,3,13
SWE,1952,Summer,23,23,24,70
SWE,1952,Winter,23,0,0,23
SWE,1956,Summer,6,14,14,34
SWE,1956,Winter,9,2,4,15
SWE,1960,Summer,3,2,2,7
SWE,1960,Winter,2,5,2,9
SWE,1964,Summer,8,3,4,15
SWE,1964,Winter,1,6,21,28
SWE,1968,Summer,1,4,4,9
SWE,1968,Winter,6,3,7,16
SWE,1972,Summer,8,4,10,22
SWE,1972,Winter,2,1,1,4
SWE,1976,Summer,0,9,1,10
SWE,1976,Winter,2,0,0,2
SWE,1980,Summer,9,3,8,20
SWE,1980,Winter,20,3,0,23
SWE,1984,Summer,13,3,18,34
SWE,1984,Winter,21,7,2,30
SWE,1988,Summer,11,0,5,16
SWE,1988,Winter,23,7,0,30
SWE,1992,Summer,7,1,27,35
SWE,1992,Winter,6,1,0,7
SWE,1994,Winter,0,23,1,24
SWE,1996,Summer,5,3,23,31
SWE,1998,Winter,5,0,2,7
SWE,2000,Summer,8,4,20,32
SWE,2002,Winter,24,0,2,26
SWE,2004,Summer,2,5,5,12
SWE,2006,Winter,8,35,21,64
SWE,2008,Summer,2,0,5,7
SWE,2010,Winter,4,11,3,18
SWE,2012,Summer,3,2,17,22
SWE,2014,Winter,11,8,32,51
SWE,2016,Summer,3,2,23,28
SYR,1984,Summer,0,0,1,1
SYR,1996,Summer,0,1,0,1
SYR,2004,Summer,1,0,0,1
TAN,1980,Summer,0,0,2,2
TCH,1920,Summer,10,0,0,10
TCH,1924,Summer,5,1,4,10
TCH,1928,Summer,2,2,12,16
TCH,1928,Winter,1,0,0,1
TCH,1932,Summer,2,1,3,6
TCH,1936,Summer,1,5,12,18
TCH,1948,Summer,3,14,3,20
TCH,1948,Winter,0,0,17,17
TCH,1952,Summer,10,11,4,25
TCH,1956,Summer,1,1,5,7
TCH,1960,Summer,11,4,7,22
TCH,1960,Winter,0,0,1,1
TCH,1964,Summer,12,5,37,54
TCH,1964,Winter,17,0,0,17
TCH,1968,Summer,15,7,7,29
TCH,1968,Winter,1,1,19,21
TCH,1972,Summer,6,2,21,29
TCH,1972,Winter,19,1,0,20
TCH,1976,Summer,9,2,4,15
TCH,1976,Winter,0,0,19,19
TCH,1980,Summer,16,17,18,51
TCH,1980,Winter,1,0,0,1
TCH,1984,Winter,4,0,24,28
TCH,1988,Summer,3,3,4,10
TCH,1988,Winter,5,0,1,6
TCH,1992,Summer,1,4,3,8
TCH,1992,Winter,27,0,0,27
TGA,1996,Summer,0,0,1,1
THA,1976,Summer,1,0,0,1
THA,1984,Summer,0,0,1,1
THA,1988,Summer,1,0,0,1
THA,1992,Summer,1,0,0,1
THA,1996,Summer,1,1,0,2
THA,2000,Summer,2,1,0,3
THA,2004,Summer,4,3,1,8
THA,2008,Summer,0,2,2,4
THA,2012,Summer,1,0,2,3
THA,2016,Summer,2,2,2,6
TJK,2008,Summer,1,0,1,2
TJK,2012,Summer,1,0,0,1
TJK,2016,Summer,0,1,0,1
TOG,2008,Summer,1,0,0,1
TPE,1960,Summer,0,0,1,1
TPE,1968,Summer,1,0,0,1
TPE,1984,Summer,1,0,0,1
TPE,1992,Summer,0,0,20,20
TPE,1996,Summer,0,0,1,1
TPE,2000,Summer,4,0,1,5
TPE,2004,Summer,3,2,4,9
TPE,2008,Summer,4,0,0,4
TPE,2012,Summer,1,0,1,2
TPE,2016,Summer,4,1,0,5
TTO,1948,Summer,0,0,1,1
TTO,1952,Summer,2,0,0,2
TTO,1964,Summer,5,0,1,6
TTO,1976,Summer,0,1,0,1
TTO,1996,Summer,2,0,0,2
TTO,2000,Summer,1,0,1,2
TTO,2004,Summer,1,0,0,1
TTO,2008,Summer,0,5,1,6
TTO,2012,Summer,5,1,4,10
TTO,2016,Summer,1,0,0,1
TUN,1964,Summer,1,0,1,2
TUN,1968,Summer,1,1,0,2
TUN,1972,Summer,0,0,1,1
TUN,1996,Summer,1,0,0,1
TUN,2008,Summer,0,1,0,1
TUN,2012,Summer,1,1,1,3
TUN,2016,Summer,3,0,0,3
TUR,1936,Summer,1,1,0,2
TUR,1948,Summer,2,6,4,12
TUR,1952,Summer,1,2,0,3
TUR,1956,Summer,2,3,2,7
TUR,1960,Summer,0,7,2,9
TUR,1964,Summer,1,2,3,6
TUR,1968,Summer,0,2,0,2
TUR,1972,Summer,0,0,1,1
TUR,1984,Summer,3,0,0,3
TUR,1988,Summer,0,1,1,2
TUR,1992,Summer,2,2,2,6
TUR,1996,Summer,1,4,1,6
TUR,2000,Summer,2,3,0,5
TUR,2004,Summer,5,3,3,11
TUR,2008,Summer,3,1,3,7
TUR,2012,Summer,1,2,2,5
TUR,2016,Summer,4,1,3,8
UAE,2004,Summer,0,1,0,1
UAE,2016,Summer,1,0,0,1
UAR,1960,Summer,1,0,1,2
UGA,1968,Summer,1,0,1,2
UGA,1972,Summer,0,1,1,2
UGA,1980,Summer,0,0,1,1
UGA,1996,Summer,1,0,0,1
UGA,2012,Summer,0,1,0,1
UKR,1994,Winter,1,1,0,2
UKR,1996,Summer,19,10,5,34
UKR,1998,Winter,0,0,1,1
UKR,2000,Summer,12,3,20,35
UKR,2004,Summer,31,8,8,47
UKR,2006,Winter,3,0,0,3
UKR,2008,Summer,16,10,5,31
UKR,2012,Summer,12,9,5,26
UKR,2014,Winter,1,4,0,5
UKR,2016,Summer,5,2,8,15
URS,1952,Summer,19,36,62,117
URS,1956,Summer,55,68,46,169
URS,1956,Winter,6,26,5,37
URS,1960,Summer,45,61,63,169
URS,1960,Winter,28,7,7,42
URS,1964,Summer,51,60,63,174
URS,1964,Winter,9,30,8,47
URS,1968,Summer,64,65,63,192
URS,1968,Winter,5,26,6,37
URS,1972,Summer,60,107,47,214
URS,1972,Winter,3,36,6,45
URS,1976,Summer,77,114,95,286
URS,1976,Winter,11,38,7,56
URS,1980,Summer,126,187,129,442
URS,1980,Winter,7,18,29,54
URS,1984,Winter,12,29,15,56
URS,1988,Summer,99,134,67,300
URS,1988,Winter,12,40,14,66
URU,1924,Summer,0,14,0,14
URU,1928,Summer,0,17,0,17
URU,1932,Summer,1,0,0,1
URU,1948,Summer,2,0,1,3
URU,1952,Summer,14,0,0,14
URU,1956,Summer,12,0,0,12
URU,1964,Summer,1,0,0,1
URU,2000,Summer,0,0,1,1
USA,1896,Summer,2,11,7,20
USA,1900,Summer,17,30,16,63
USA,1904,Summer,125,128,141,394
USA,1906,Summer,6,12,6,24
USA,1908,Summer,15,34,16,65
USA,1912,Summer,36,46,25,107
USA,1920,Summer,38,111,45,194
USA,1924,Summer,49,97,36,182
USA,1924,Winter,1,1,10,12
USA,1928,Summer,17,47,24,88
USA,1928,Winter,2,6,6,14
USA,1932,Summer,61,81,47,189
USA,1932,Winter,3,10,21,34
USA,1936,Summer,16,51,29,96
USA,1936,Winter,14,2,0,16
USA,1948,Summer,35,87,30,152
USA,1948,Winter,6,6,4,16
USA,1952,Summer,28,83,23,134
USA,1952,Winter,1,4,25,30
USA,1956,Summer,20,61,42,123
USA,1956,Winter,5,2,19,26
USA,1960,Summer,21,81,23,125
USA,1960,Winter,4,19,4,27
USA,1964,Summer,37,95,37,169
USA,1964,Winter,5,1,2,8
USA,1968,Summer,35,99,32,166
USA,1968,Winter,1,1,5,7
USA,1972,Summer,43,69,59,171
USA,1972,Winter,3,3,18,24
USA,1976,Summer,36,70,58,164
USA,1976,Winter,5,3,3,11
USA,1980,Winter,2,24,4,30
USA,1984,Summer,50,186,116,352
USA,1984,Winter,0,4,5,9
USA,1988,Summer,54,87,66,207
USA,1988,Winter,4,2,1,7
USA,1992,Summer,85,89,50,224
USA,1992,Winter,2,5,7,14
USA,1994,Winter,5,6,8,19
USA,1996,Summer,52,159,48,259
USA,1998,Winter,5,25,4,34
USA,2000,Summer,51,130,61,242
USA,2002,Winter,15,11,58,84
USA,2004,Summer,71,117,75,263
USA,2006,Winter,32,9,11,52
USA,2008,Summer,80,127,110,317
USA,2010,Winter,22,12,63,97
USA,2012,Summer,46,145,57,248
USA,2014,Winter,24,10,30,64
USA,2016,Summer,71,139,54,264
UZB,1994,Winter,0,1,0,1
UZB,1996,Summer,1,0,1,2
UZB,2000,Summer,2,1,1,4
UZB,2004,Summer,2,2,1,5
UZB,2008,Summer,3,1,2,6
UZB,2012,Summer,2,1,0,3
UZB,2016,Summer,7,4,2,13
VEN,1952,Summer,1,0,0,1
VEN,1960,Summer,1,0,0,1
VEN,1968,Summer,0,1,0,1
VEN,1976,Summer,0,0,1,1
VEN,1980,Summer,0,0,1,1
VEN,1984,Summer,3,0,0,3
VEN,2004,Summer,2,0,0,2
VEN,2008,Summer,1,0,0,1
VEN,2012,Summer,0,1,0,1
VEN,2016,Summer,2,0,1,3
VIE,2000,Summer,0,0,1,1
VIE,2008,Summer,0,0,1,1
VIE,2016,Summer,0,1,1,2
WIF,1960,Summer,5,0,0,5
YUG,1924,Summer,0,2,0,2
YUG,1928,Summer,10,1,1,12
YUG,1936,Summer,0,0,1,1
YUG,1948,Summer,0,0,16,16
YUG,1952,Summer,0,4,20,24
YUG,1956,Summer,0,0,23,23
YUG,1960,Summer,0,16,1,17
YUG,1964,Summer,2,2,11,15
YUG,1968,Summer,2,13,14,29
YUG,1972,Summer,2,15,1,18
YUG,1976,Summer,3,2,14,19
YUG,1980,Summer,17,13,27,57
YUG,1984,Summer,35,47,5,87
YUG,1984,Winter,0,0,1,1
YUG,1988,Summer,21,15,27,63
YUG,1988,Winter,1,0,5,6
ZAM,1984,Summer,1,0,0,1
ZAM,1996,Summer,0,0,1,1
ZIM,1980,Summer,0,15,0,15
ZIM,2004,Summer,1,1,1,3
ZIM,2008,Summer,0,1,3,4
