noc,season,year,Bronze,Gold,Silver,Total_Medals,numeric_id
AFG,Summer,2008,1,0,0,1,4
AFG,Summer,2012,1,0,0,1,4
AHO,Summer,1988,0,0,1,1,0
ALG,Summer,1984,2,0,0,2,0
ALG,Summer,1992,1,1,0,2,0
ALG,Summer,1996,1,2,0,3,0
ALG,Summer,2000,3,1,1,5,0
ALG,Summer,2008,1,0,1,2,0
ALG,Summer,2012,0,1,0,1,0
ALG,Summer,2016,0,0,2,2,0
ANZ,Summer,1908,2,15,2,19,0
ANZ,Summer,1912,3,5,2,10,0
ARG,Summer,1924,2,5,3,10,32
ARG,Summer,1928,5,3,18,26,32
ARG,Summer,1932,0,3,1,4,32
ARG,Summer,1936,4,5,2,11,32
ARG,Summer,1948,1,3,7,11,32
ARG,Summer,1952,2,2,2,6,32
ARG,Summer,1956,1,0,1,2,32
ARG,Summer,1960,1,0,3,4,32
ARG,Summer,1964,0,0,1,1,32
ARG,Summer,1968,2,0,0,2,32
ARG,Summer,1972,0,0,1,1,32
ARG,Summer,1988,12,0,1,13,32
ARG,Summer,1992,2,0,0,2,32
ARG,Summer,1996,1,0,19,20,32
ARG,Summer,2000,3,0,17,20,32
ARG,Summer,2004,21,28,0,49,32
ARG,Summer,2008,31,20,0,51,32
ARG,Summer,2012,3,1,15,19,32
ARG,Summer,2016,0,21,1,22,32
ARM,Summer,1996,0,1,1,2,51
ARM,Summer,2000,1,0,0,1,51
ARM,Summer,2008,6,0,0,6,51
ARM,Summer,2012,2,0,1,3,51
ARM,Summer,2016,0,1,3,4,51
AUS,Summer,1896,1,2,0,3,36
AUS,Summer,1900,3,3,0,6,36
AUS,Summer,1904,1,0,3,4,36
AUS,Summer,1906,3,0,0,3,36
AUS,Summer,1920,1,0,6,7,36
AUS,Summer,1924,2,3,5,10,36
AUS,Summer,1928,1,1,2,4,36
AUS,Summer,1932,1,3,1,5,36
AUS,Summer,1936,1,0,0,1,36
AUS,Summer,1948,5,2,9,16,36
AUS,Summer,1952,11,7,2,20,36
AUS,Summer,1956,26,28,13,67,36
AUS,Summer,1960,11,11,24,46,36
AUS,Summer,1964,30,8,6,44,36
AUS,Summer,1968,11,5,35,51,36
AUS,Summer,1972,2,11,7,20,36
AUS,Summer,1976,8,0,15,23,36
AUS,Summer,1980,5,6,2,13,36
AUS,Summer,1984,31,7,14,52,36
AUS,Summer,1988,11,18,6,35,36
AUS,Summer,1992,16,14,27,57,36
AUS,Summer,1996,84,32,16,132,36
AUS,Summer,2000,54,60,69,183,36
AUS,Summer,2004,31,49,77,157,36
AUS,Summer,2008,76,31,42,149,36
AUS,Summer,2012,59,18,37,114,36
AUS,Summer,2016,25,23,34,82,36
AUS,Winter,1924,0,1,0,1,36
AUS,Winter,1994,4,0,0,4,36
AUS,Winter,1998,1,0,0,1,36
AUS,Winter,2002,0,2,0,2,36
AUS,Winter,2006,1,1,0,2,36
AUS,Winter,2010,0,2,1,3,36
AUS,Winter,2014,1,0,2,3,36
AUT,Summer,1896,2,2,1,5,40
AUT,Summer,1900,3,0,3,6,40
AUT,Summer,1904,1,2,1,4,40
AUT,Summer,1906,3,3,3,9,40
AUT,Summer,1908,1,0,0,1,40
AUT,Summer,1912,5,0,9,14,40
AUT,Summer,1924,1,0,3,4,40
AUT,Summer,1928,2,3,0,5,40
AUT,Summer,1932,3,1,1,5,40
AUT,Summer,1936,7,6,42,55,40
AUT,Summer,1948,4,2,2,8,40
AUT,Summer,1952,2,0,1,3,40
AUT,Summer,1956,4,0,0,4,40
AUT,Summer,1960,0,1,2,3,40
AUT,Summer,1968,3,0,2,5,40
AUT,Summer,1972,2,0,1,3,40
AUT,Summer,1976,1,0,0,1,40
AUT,Summer,1980,1,1,3,5,40
AUT,Summer,1984,1,1,1,3,40
AUT,Summer,1988,0,1,0,1,40
AUT,Summer,1992,0,0,6,6,40
AUT,Summer,1996,2,0,1,3,40
AUT,Summer,2000,0,3,1,4,40
AUT,Summer,2004,1,3,4,8,40
AUT,Summer,2008,2,0,1,3,40
AUT,Summer,2016,2,0,0,2,40
AUT,Winter,1924,0,3,1,4,40
AUT,Winter,1928,2,0,4,6,40
AUT,Winter,1932,0,1,1,2,40
AUT,Winter,1936,2,1,2,5,40
AUT,Winter,1948,4,1,3,8,40
AUT,Winter,1952,2,2,4,8,40
AUT,Winter,1956,4,5,3,12,40
AUT,Winter,1960,3,1,2,6,40
AUT,Winter,1964,3,5,9,17,40
AUT,Winter,1968,4,3,8,15,40
AUT,Winter,1972,2,1,2,5,40
AUT,Winter,1976,3,2,2,7,40
AUT,Winter,1980,3,3,2,8,40
AUT,Winter,1984,1,0,0,1,40
AUT,Winter,1988,4,3,5,12,40
AUT,Winter,1992,10,9,10,29,40
AUT,Winter,1994,7,2,3,12,40
AUT,Winter,1998,12,3,5,20,40
AUT,Winter,2002,13,3,4,20,40
AUT,Winter,2006,7,16,7,30,40
AUT,Winter,2010,6,11,9,26,40
AUT,Winter,2014,11,4,12,27,40
AZE,Summer,1996,0,0,1,1,31
AZE,Summer,2000,1,2,0,3,31
AZE,Summer,2004,4,1,0,5,31
AZE,Summer,2008,4,1,2,7,31
AZE,Summer,2012,6,2,2,10,31
AZE,Summer,2016,10,1,7,18,31
BAH,Summer,1956,2,0,0,2,0
BAH,Summer,1964,0,2,0,2,0
BAH,Summer,1992,1,0,0,1,0
BAH,Summer,1996,0,0,5,5,0
BAH,Summer,2000,5,6,0,11,0
BAH,Summer,2004,1,1,0,2,0
BAH,Summer,2008,1,0,6,7,0
BAH,Summer,2012,0,4,0,4,0
BAH,Summer,2016,5,1,0,6,0
BAR,Summer,2000,1,0,0,1,0
BDI,Summer,1996,0,1,0,1,108
BDI,Summer,2016,0,0,1,1,108
BEL,Summer,1900,13,6,24,43,56
BEL,Summer,1906,6,2,3,11,56
BEL,Summer,1908,8,1,24,33,56
BEL,Summer,1912,11,7,1,19,56
BEL,Summer,1920,66,57,65,188,56
BEL,Summer,1924,6,3,30,39,56
BEL,Summer,1928,4,0,1,5,56
BEL,Summer,1932,1,0,0,1,56
BEL,Summer,1936,14,0,0,14,56
BEL,Summer,1948,8,5,2,15,56
BEL,Summer,1952,0,5,3,8,56
BEL,Summer,1956,0,0,2,2,56
BEL,Summer,1960,2,0,2,4,56
BEL,Summer,1964,1,2,0,3,56
BEL,Summer,1968,2,0,1,3,56
BEL,Summer,1972,0,0,2,2,56
BEL,Summer,1976,6,0,3,9,56
BEL,Summer,1980,0,1,0,1,56
BEL,Summer,1984,2,1,2,5,56
BEL,Summer,1988,2,0,0,2,56
BEL,Summer,1992,2,0,1,3,56
BEL,Summer,1996,2,2,2,6,56
BEL,Summer,2000,4,0,3,7,56
BEL,Summer,2004,2,1,0,3,56
BEL,Summer,2008,0,1,4,5,56
BEL,Summer,2012,2,0,1,3,56
BEL,Summer,2016,2,2,17,21,56
BEL,Winter,1924,5,0,0,5,56
BEL,Winter,1928,1,0,0,1,56
BEL,Winter,1948,0,2,4,6,56
BEL,Winter,1998,1,0,0,1,56
BER,Summer,1976,1,0,0,1,0
BLR,Summer,1996,16,1,6,23,112
BLR,Summer,2000,11,3,8,22,112
BLR,Summer,2004,8,2,5,15,112
BLR,Summer,2008,16,8,5,29,112
BLR,Summer,2012,8,3,12,23,112
BLR,Summer,2016,7,1,4,12,112
BLR,Winter,1994,0,0,2,2,112
BLR,Winter,1998,2,0,0,2,112
BLR,Winter,2002,1,0,0,1,112
BLR,Winter,2006,0,0,1,1,112
BLR,Winter,2010,1,1,1,3,112
BLR,Winter,2014,1,5,0,6,112
BOH,Summer,1900,2,0,1,3,0
BOH,Summer,1906,3,0,0,3,0
BOH,Summer,1908,6,0,0,6,0
BOT,Summer,2012,0,0,1,1,0
BRA,Summer,1920,5,1,1,7,76
BRA,Summer,1948,10,0,0,10,76
BRA,Summer,1952,2,1,0,3,76
BRA,Summer,1956,0,1,0,1,76
BRA,Summer,1960,13,0,0,13,76
BRA,Summer,1964,12,0,0,12,76
BRA,Summer,1968,3,0,1,4,76
BRA,Summer,1972,2,0,0,2,76
BRA,Summer,1976,3,0,0,3,76
BRA,Summer,1980,5,4,0,9,76
BRA,Summer,1984,2,1,33,36,76
BRA,Summer,1988,5,1,17,23,76
BRA,Summer,1992,0,13,1,14,76
BRA,Summer,1996,43,5,15,63,76
BRA,Summer,2000,36,0,12,48,76
BRA,Summer,2004,3,18,19,40,76
BRA,Summer,2008,30,14,34,78,76
BRA,Summer,2012,11,14,34,59,76
BRA,Summer,2016,6,36,8,50,76
BRN,Summer,2012,1,0,0,1,96
BRN,Summer,2016,0,1,1,2,96
BUL,Summer,1952,1,0,0,1,0
BUL,Summer,1956,14,1,3,18,0
BUL,Summer,1960,3,1,3,7,0
BUL,Summer,1964,2,3,5,10,0
BUL,Summer,1968,3,2,21,26,0
BUL,Summer,1972,6,6,10,22,0
BUL,Summer,1976,18,8,13,39,0
BUL,Summer,1980,38,8,44,90,0
BUL,Summer,1988,17,10,14,41,0
BUL,Summer,1992,7,3,7,17,0
BUL,Summer,1996,6,3,12,21,0
BUL,Summer,2000,2,5,6,13,0
BUL,Summer,2004,14,2,1,17,0
BUL,Summer,2008,3,1,1,5,0
BUL,Summer,2012,1,0,1,2,0
BUL,Summer,2016,6,0,1,7,0
BUL,Winter,1980,1,0,0,1,0
BUL,Winter,1998,0,1,0,1,0
BUL,Winter,2002,2,0,1,3,0
BUL,Winter,2006,0,0,1,1,0
CAN,Summer,1900,1,1,0,2,124
CAN,Summer,1904,12,27,9,48,124
CAN,Summer,1906,0,1,1,2,124
CAN,Summer,1908,30,14,8,52,124
CAN,Summer,1912,3,3,2,8,124
CAN,Summer,1920,3,10,3,16,124
CAN,Summer,1924,1,0,19,20,124
CAN,Summer,1928,21,7,5,33,124
CAN,Summer,1932,24,2,13,39,124
CAN,Summer,1936,9,1,12,22,124
CAN,Summer,1948,5,0,2,7,124
CAN,Summer,1952,0,1,3,4,124
CAN,Summer,1956,5,5,9,19,124
CAN,Summer,1960,0,0,9,9,124
CAN,Summer,1964,1,2,2,5,124
CAN,Summer,1968,4,3,3,10,124
CAN,Summer,1972,9,0,2,11,124
CAN,Summer,1976,14,0,9,23,124
CAN,Summer,1984,32,19,36,87,124
CAN,Summer,1988,14,4,5,23,124
CAN,Summer,1992,12,27,5,44,124
CAN,Summer,1996,12,8,30,50,124
CAN,Summer,2000,23,4,4,31,124
CAN,Summer,2004,4,3,10,17,124
CAN,Summer,2008,11,11,13,35,124
CAN,Summer,2012,33,1,21,55,124
CAN,Summer,2016,61,4,4,69,124
CAN,Winter,1924,0,9,0,9,124
CAN,Winter,1928,0,12,0,12,124
CAN,Winter,1932,5,14,1,20,124
CAN,Winter,1936,0,0,13,13,124
CAN,Winter,1948,2,13,0,15,124
CAN,Winter,1952,1,16,0,17,124
CAN,Winter,1956,18,0,2,20,124
CAN,Winter,1960,1,3,17,21,124
CAN,Winter,1964,1,4,2,7,124
CAN,Winter,1968,18,1,1,20,124
CAN,Winter,1972,0,0,1,1,124
CAN,Winter,1976,1,1,1,3,124
CAN,Winter,1980,1,0,1,2,124
CAN,Winter,1984,1,2,1,4,124
CAN,Winter,1988,4,0,2,6,124
CAN,Winter,1992,3,5,28,36,124
CAN,Winter,1994,5,3,29,37,124
CAN,Winter,1998,7,14,28,49,124
CAN,Winter,2002,15,52,7,74,124
CAN,Winter,2006,11,30,28,69,124
CAN,Winter,2010,8,67,15,90,124
CAN,Winter,2014,5,59,22,86,124
CHI,Summer,1928,0,0,1,1,0
CHI,Summer,1952,0,0,4,4,0
CHI,Summer,1956,2,0,2,4,0
CHI,Summer,1988,0,0,1,1,0
CHI,Summer,2000,17,0,0,17,0
CHI,Summer,2004,1,3,0,4,0
CHI,Summer,2008,0,0,1,1,0
CHN,Summer,1984,37,24,13,74,156
CHN,Summer,1988,30,6,16,52,156
CHN,Summer,1992,19,18,45,82,156
CHN,Summer,1996,17,19,70,106,156
CHN,Summer,2000,17,39,23,79,156
CHN,Summer,2004,15,52,27,94,156
CHN,Summer,2008,57,74,53,184,156
CHN,Summer,2012,29,56,40,125,156
CHN,Summer,2016,37,46,30,113,156
CHN,Winter,1992,0,0,3,3,156
CHN,Winter,1994,2,0,1,3,156
CHN,Winter,1998,5,0,9,14,156
CHN,Winter,2002,9,2,5,16,156
CHN,Winter,2006,6,2,5,13,156
CHN,Winter,2010,7,9,3,19,156
CHN,Winter,2014,5,3,4,12,156
CIV,Summer,1984,0,0,1,1,384
CIV,Summer,2016,1,1,0,2,384
CMR,Summer,1968,0,0,1,1,120
CMR,Summer,1984,1,0,0,1,120
CMR,Summer,2000,0,18,0,18,120
CMR,Summer,2004,0,1,0,1,120
CMR,Summer,2008,0,1,0,1,120
COL,Summer,1900,0,0,1,1,170
COL,Summer,1972,2,0,1,3,170
COL,Summer,1984,0,0,1,1,170
COL,Summer,1988,1,0,0,1,170
COL,Summer,1992,1,0,0,1,170
COL,Summer,2000,0,1,0,1,170
COL,Summer,2004,2,0,0,2,170
COL,Summer,2008,1,0,1,2,170
COL,Summer,2012,4,1,3,8,170
COL,Summer,2016,3,3,2,8,170
CRC,Summer,1988,0,0,1,1,0
CRC,Summer,1996,0,1,0,1,0
CRC,Summer,2000,2,0,0,2,0
CRO,Summer,1992,3,0,12,15,0
CRO,Summer,1996,0,16,12,28,0
CRO,Summer,2000,9,1,0,10,0
CRO,Summer,2004,3,15,3,21,0
CRO,Summer,2008,3,0,2,5,0
CRO,Summer,2012,16,15,4,35,0
CRO,Summer,2016,2,7,15,24,0
CRO,Winter,2002,0,3,1,4,0
CRO,Winter,2006,0,1,2,3,0
CRO,Winter,2010,1,0,2,3,0
CRO,Winter,2014,0,0,1,1,0
CUB,Summer,1900,0,1,1,2,192
CUB,Summer,1904,0,5,0,5,192
CUB,Summer,1948,0,0,2,2,192
CUB,Summer,1964,0,0,1,1,192
CUB,Summer,1968,0,0,10,10,192
CUB,Summer,1972,18,3,1,22,192
CUB,Summer,1976,14,6,4,24,192
CUB,Summer,1980,5,8,7,20,192
CUB,Summer,1992,14,42,13,69,192
CUB,Summer,1996,10,37,8,55,192
CUB,Summer,2000,12,18,35,65,192
CUB,Summer,2004,22,32,8,62,192
CUB,Summer,2008,11,2,34,47,192
CUB,Summer,2012,6,5,3,14,192
CUB,Summer,2016,4,5,2,11,192
CYP,Summer,2012,0,0,1,1,196
CZE,Summer,1996,4,4,5,13,203
CZE,Summer,2000,4,2,3,9,203
CZE,Summer,2004,6,1,6,13,203
CZE,Summer,2008,0,3,4,7,203
CZE,Summer,2012,6,4,4,14,203
CZE,Summer,2016,12,1,2,15,203
CZE,Winter,1998,1,21,1,23,203
CZE,Winter,2002,0,1,2,3,203
CZE,Winter,2006,24,1,2,27,203
CZE,Winter,2010,7,2,0,9,203
CZE,Winter,2014,2,2,7,11,203
DEN,Summer,1896,3,1,2,6,0
DEN,Summer,1900,2,4,3,9,0
DEN,Summer,1906,1,14,19,34,0
DEN,Summer,1908,3,0,14,17,0
DEN,Summer,1912,33,5,49,87,0
DEN,Summer,1920,1,26,44,71,0
DEN,Summer,1924,3,2,9,14,0
DEN,Summer,1928,4,6,5,15,0
DEN,Summer,1932,4,0,7,11,0
DEN,Summer,1936,3,0,3,6,0
DEN,Summer,1948,27,7,17,51,0
DEN,Summer,1952,5,3,1,9,0
DEN,Summer,1956,1,1,4,6,0
DEN,Summer,1960,4,2,17,23,0
DEN,Summer,1964,4,7,1,12,0
DEN,Summer,1968,6,5,6,17,0
DEN,Summer,1972,0,1,0,1,0
DEN,Summer,1976,5,3,0,8,0
DEN,Summer,1980,2,4,2,8,0
DEN,Summer,1984,10,0,3,13,0
DEN,Summer,1988,3,3,1,7,0
DEN,Summer,1992,9,3,2,14,0
DEN,Summer,1996,1,21,1,23,0
DEN,Summer,2000,4,18,3,25,0
DEN,Summer,2004,9,19,1,29,0
DEN,Summer,2008,6,6,7,19,0
DEN,Summer,2012,8,3,5,16,0
DEN,Summer,2016,16,15,10,41,0
DEN,Winter,1998,0,0,5,5,0
DJI,Summer,1988,1,0,0,1,262
DOM,Summer,1984,1,0,0,1,214
DOM,Summer,2004,0,1,0,1,214
DOM,Summer,2008,0,1,1,2,214
DOM,Summer,2012,0,1,1,2,214
DOM,Summer,2016,1,0,0,1,214
ECU,Summer,1996,0,1,0,1,218
ECU,Summer,2008,0,0,1,1,218
EGY,Summer,1928,1,2,1,4,818
EGY,Summer,1936,2,2,1,5,818
EGY,Summer,1948,1,2,2,5,818
EGY,Summer,1952,1,0,0,1,818
EGY,Summer,1984,0,0,1,1,818
EGY,Summer,2004,3,1,1,5,818
EGY,Summer,2008,1,0,0,1,818
EGY,Summer,2012,0,0,2,2,818
EGY,Summer,2016,3,0,0,3,818
ERI,Summer,2004,1,0,0,1,232
ESP,Summer,1900,0,2,0,2,724
ESP,Summer,1920,0,0,23,23,724
ESP,Summer,1928,0,3,0,3,724
ESP,Summer,1932,1,0,0,1,724
ESP,Summer,1948,0,0,3,3,724
ESP,Summer,1952,0,0,1,1,724
ESP,Summer,1960,14,0,0,14,724
ESP,Summer,1972,1,0,0,1,724
ESP,Summer,1976,0,0,6,6,724
ESP,Summer,1980,3,2,19,24,724
ESP,Summer,1984,3,2,14,19,724
ESP,Summer,1988,2,1,2,5,724
ESP,Summer,1992,2,48,19,69,724
ESP,Summer,1996,22,23,21,66,724
ESP,Summer,2000,20,3,19,42,724
ESP,Summer,2004,9,4,17,30,724
ESP,Summer,2008,16,7,47,70,724
ESP,Summer,2012,25,5,33,63,724
ESP,Summer,2016,17,9,19,45,724
ESP,Winter,1972,0,1,0,1,724
ESP,Winter,1992,1,0,0,1,724
EST,Summer,1920,0,1,2,3,233
EST,Summer,1924,4,1,1,6,233
EST,Summer,1928,6,2,1,9,233
EST,Summer,1936,3,2,2,7,233
EST,Summer,1992,2,1,0,3,233
EST,Summer,2000,2,1,0,3,233
EST,Summer,2004,2,0,1,3,233
EST,Summer,2008,0,1,2,3,233
EST,Summer,2012,1,0,1,2,233
EST,Summer,2016,4,0,0,4,233
EST,Winter,2002,1,1,1,3,233
EST,Winter,2006,0,3,0,3,233
EST,Winter,2010,0,0,1,1,233
ETH,Summer,1960,0,1,0,1,231
ETH,Summer,1964,0,1,0,1,231
ETH,Summer,1968,0,1,1,2,231
ETH,Summer,1972,2,0,0,2,231
ETH,Summer,1980,2,2,0,4,231
ETH,Summer,1992,2,1,0,3,231
ETH,Summer,1996,1,2,0,3,231
ETH,Summer,2000,3,4,1,8,231
ETH,Summer,2004,2,2,3,7,231
ETH,Summer,2008,2,4,1,7,231
ETH,Summer,2012,3,3,1,7,231
ETH,Summer,2016,5,1,2,8,231
EUN,Summer,1992,67,92,61,220,0
EUN,Winter,1992,14,35,10,59,0
FIJ,Summer,2016,0,13,0,13,0
FIN,Summer,1906,1,2,1,4,246
FIN,Summer,1908,28,1,1,30,246
FIN,Summer,1912,22,9,40,71,246
FIN,Summer,1920,17,21,14,52,246
FIN,Summer,1924,15,24,13,52,246
FIN,Summer,1928,9,8,8,25,246
FIN,Summer,1932,16,5,8,29,246
FIN,Summer,1936,13,8,6,27,246
FIN,Summer,1948,8,17,8,33,246
FIN,Summer,1952,29,8,3,40,246
FIN,Summer,1956,22,3,1,26,246
FIN,Summer,1960,4,1,1,6,246
FIN,Summer,1964,2,3,0,5,246
FIN,Summer,1968,1,1,2,4,246
FIN,Summer,1972,6,3,1,10,246
FIN,Summer,1976,0,4,2,6,246
FIN,Summer,1980,5,3,1,9,246
FIN,Summer,1984,6,4,2,12,246
FIN,Summer,1988,2,1,1,4,246
FIN,Summer,1992,2,1,4,7,246
FIN,Summer,1996,1,1,2,4,246
FIN,Summer,2000,1,3,1,5,246
FIN,Summer,2004,0,0,2,2,246
FIN,Summer,2008,2,1,2,5,246
FIN,Summer,2012,4,0,1,5,246
FIN,Summer,2016,1,0,0,1,246
FIN,Winter,1924,3,4,8,15,246
FIN,Winter,1928,1,2,1,4,246
FIN,Winter,1932,1,1,1,3,246
FIN,Winter,1936,3,4,2,9,246
FIN,Winter,1948,2,1,6,9,246
FIN,Winter,1952,2,6,4,12,246
FIN,Winter,1956,1,5,6,12,246
FIN,Winter,1960,5,5,3,13,246
FIN,Winter,1964,5,3,7,15,246
FIN,Winter,1968,5,1,2,8,246
FIN,Winter,1972,1,0,9,10,246
FIN,Winter,1976,1,5,10,16,246
FIN,Winter,1980,6,1,5,12,246
FIN,Winter,1984,12,4,3,19,246
FIN,Winter,1988,5,7,22,34,246
FIN,Winter,1992,6,6,1,13,246
FIN,Winter,1994,29,0,1,30,246
FIN,Winter,1998,49,2,7,58,246
FIN,Winter,2002,1,7,5,13,246
FIN,Winter,2006,7,0,34,41,246
FIN,Winter,2010,46,0,1,47,246
FIN,Winter,2014,24,2,7,33,246
FRA,Summer,1896,2,5,4,11,250
FRA,Summer,1900,82,52,101,235,250
FRA,Summer,1904,0,0,2,2,250
FRA,Summer,1906,28,20,16,64,250
FRA,Summer,1908,23,12,5,40,250
FRA,Summer,1912,5,10,11,26,250
FRA,Summer,1920,57,13,71,141,250
FRA,Summer,1924,22,37,51,110,250
FRA,Summer,1928,14,12,24,50,250
FRA,Summer,1932,6,26,8,40,250
FRA,Summer,1936,18,13,13,44,250
FRA,Summer,1948,24,26,22,72,250
FRA,Summer,1952,17,14,9,40,250
FRA,Summer,1956,13,7,13,33,250
FRA,Summer,1960,6,0,6,12,250
FRA,Summer,1964,17,1,13,31,250
FRA,Summer,1968,10,12,5,27,250
FRA,Summer,1972,15,2,5,22,250
FRA,Summer,1976,8,5,7,20,250
FRA,Summer,1980,6,18,5,29,250
FRA,Summer,1984,31,20,16,67,250
FRA,Summer,1988,13,12,4,29,250
FRA,Summer,1992,43,9,5,57,250
FRA,Summer,1996,20,21,10,51,250
FRA,Summer,2000,14,22,30,66,250
FRA,Summer,2004,22,21,10,53,250
FRA,Summer,2008,28,25,24,77,250
FRA,Summer,2012,22,30,30,82,250
FRA,Summer,2016,21,20,55,96,250
FRA,Winter,1924,10,0,0,10,250
FRA,Winter,1928,0,2,0,2,250
FRA,Winter,1932,0,2,0,2,250
FRA,Winter,1936,1,0,0,1,250
FRA,Winter,1948,2,2,1,5,250
FRA,Winter,1952,1,0,0,1,250
FRA,Winter,1960,2,1,0,3,250
FRA,Winter,1964,0,3,4,7,250
FRA,Winter,1968,2,4,3,9,250
FRA,Winter,1972,2,0,1,3,250
FRA,Winter,1976,1,0,0,1,250
FRA,Winter,1980,1,0,0,1,250
FRA,Winter,1984,2,0,1,3,250
FRA,Winter,1988,1,1,0,2,250
FRA,Winter,1992,1,5,6,12,250
FRA,Winter,1994,10,0,1,11,250
FRA,Winter,1998,12,2,1,15,250
FRA,Winter,2002,5,5,5,15,250
FRA,Winter,2006,10,3,2,15,250
FRA,Winter,2010,6,2,6,14,250
FRA,Winter,2014,10,4,4,18,250
FRG,Summer,1968,18,17,16,51,0
FRG,Summer,1972,39,44,19,102,0
FRG,Summer,1976,32,21,25,78,0
FRG,Summer,1984,53,30,75,158,0
FRG,Summer,1988,46,32,37,115,0
FRG,Winter,1968,5,2,3,10,0
FRG,Winter,1972,4,4,2,10,0
FRG,Winter,1976,23,2,7,32,0
FRG,Winter,1980,6,0,2,8,0
FRG,Winter,1984,4,3,1,8,0
FRG,Winter,1988,3,4,7,14,0
GAB,Summer,2012,0,0,1,1,266
GBR,Summer,1896,3,3,3,9,826
GBR,Summer,1900,15,59,34,108,826
GBR,Summer,1904,0,1,1,2,826
GBR,Summer,1906,8,9,22,39,826
GBR,Summer,1908,90,147,131,368,826
GBR,Summer,1912,59,47,64,170,826
GBR,Summer,1920,17,52,42,111,826
GBR,Summer,1924,19,15,30,64,826
GBR,Summer,1928,24,7,27,58,826
GBR,Summer,1932,14,9,12,35,826
GBR,Summer,1936,8,12,16,36,826
GBR,Summer,1948,12,7,42,61,826
GBR,Summer,1952,26,3,2,31,826
GBR,Summer,1956,22,8,16,46,826
GBR,Summer,1960,15,2,11,28,826
GBR,Summer,1964,5,4,19,28,826
GBR,Summer,1968,5,9,5,19,826
GBR,Summer,1972,12,8,9,29,826
GBR,Summer,1976,11,6,15,32,826
GBR,Summer,1980,24,5,18,47,826
GBR,Summer,1984,42,9,20,71,826
GBR,Summer,1988,15,22,17,54,826
GBR,Summer,1992,39,8,3,50,826
GBR,Summer,1996,9,2,15,26,826
GBR,Summer,2000,12,22,20,54,826
GBR,Summer,2004,15,17,25,57,826
GBR,Summer,2008,25,31,25,81,826
GBR,Summer,2012,48,48,30,126,826
GBR,Summer,2016,26,64,55,145,826
GBR,Winter,1924,11,16,4,31,826
GBR,Winter,1928,1,0,0,1,826
GBR,Winter,1936,4,12,1,17,826
GBR,Winter,1948,2,0,0,2,826
GBR,Winter,1952,0,1,0,1,826
GBR,Winter,1964,0,2,0,2,826
GBR,Winter,1976,0,1,0,1,826
GBR,Winter,1980,0,1,0,1,826
GBR,Winter,1984,0,2,0,2,826
GBR,Winter,1994,3,0,0,3,826
GBR,Winter,1998,4,0,0,4,826
GBR,Winter,2002,1,5,0,6,826
GBR,Winter,2006,0,0,1,1,826
GBR,Winter,2010,0,1,0,1,826
GBR,Winter,2014,5,1,4,10,826
GDR,Summer,1968,19,13,20,52,0
GDR,Summer,1972,57,30,64,151,0
GDR,Summer,1976,42,102,51,195,0
GDR,Summer,1980,61,115,88,264,0
GDR,Summer,1988,48,79,54,181,0
GDR,Winter,1968,2,2,2,6,0
GDR,Winter,1972,12,5,3,20,0
GDR,Winter,1976,14,12,6,32,0
GDR,Winter,1980,12,16,11,39,0
GDR,Winter,1984,7,13,13,33,0
GDR,Winter,1988,7,10,15,32,0
GEO,Summer,1996,2,0,0,2,268
GEO,Summer,2000,6,0,0,6,268
GEO,Summer,2004,0,2,2,4,268
GEO,Summer,2008,3,3,0,6,268
GEO,Summer,2012,3,1,3,7,268
GEO,Summer,2016,4,2,1,7,268
GER,Summer,1896,2,25,5,32,0
GER,Summer,1900,11,14,20,45,0
GER,Summer,1904,7,4,5,16,0
GER,Summer,1906,6,14,10,30,0
GER,Summer,1908,6,4,11,21,0
GER,Summer,1912,23,11,19,53,0
GER,Summer,1928,41,21,15,77,0
GER,Summer,1932,7,10,26,43,0
GER,Summer,1936,61,93,70,224,0
GER,Summer,1952,26,0,14,40,0
GER,Summer,1956,23,9,20,52,0
GER,Summer,1960,22,34,33,89,0
GER,Summer,1964,50,22,44,116,0
GER,Summer,1992,60,81,57,198,0
GER,Summer,1996,47,42,35,124,0
GER,Summer,2000,64,31,23,118,0
GER,Summer,2004,63,41,45,149,0
GER,Summer,2008,41,42,16,99,0
GER,Summer,2012,22,45,27,94,0
GER,Summer,2016,67,49,43,159,0
GER,Winter,1928,5,0,0,5,0
GER,Winter,1932,14,0,0,14,0
GER,Winter,1936,0,4,3,7,0
GER,Winter,1952,2,8,2,12,0
GER,Winter,1956,1,1,0,2,0
GER,Winter,1960,1,4,4,9,0
GER,Winter,1964,3,3,4,10,0
GER,Winter,1992,7,14,17,38,0
GER,Winter,1994,12,18,10,40,0
GER,Winter,1998,10,22,12,44,0
GER,Winter,2002,12,26,23,61,0
GER,Winter,2006,6,23,25,54,0
GER,Winter,2010,15,15,24,54,0
GER,Winter,2014,9,15,12,36,0
GHA,Summer,1960,0,0,1,1,288
GHA,Summer,1964,1,0,0,1,288
GHA,Summer,1972,1,0,0,1,288
GHA,Summer,1992,20,0,0,20,288
GRE,Summer,1896,20,10,18,48,0
GRE,Summer,1904,1,1,0,2,0
GRE,Summer,1906,30,24,48,102,0
GRE,Summer,1908,1,0,3,4,0
GRE,Summer,1912,1,1,0,2,0
GRE,Summer,1920,0,0,5,5,0
GRE,Summer,1924,0,1,0,1,0
GRE,Summer,1956,1,0,0,1,0
GRE,Summer,1960,0,3,0,3,0
GRE,Summer,1968,1,0,0,1,0
GRE,Summer,1972,0,0,2,2,0
GRE,Summer,1980,4,1,0,5,0
GRE,Summer,1984,1,0,1,2,0
GRE,Summer,1988,1,0,0,1,0
GRE,Summer,1992,0,2,0,2,0
GRE,Summer,1996,0,4,4,8,0
GRE,Summer,2000,8,4,6,18,0
GRE,Summer,2004,5,8,18,31,0
GRE,Summer,2008,4,0,3,7,0
GRE,Summer,2012,3,0,0,3,0
GRE,Summer,2016,3,3,1,7,0
GRN,Summer,2012,0,1,0,1,0
GRN,Summer,2016,0,0,1,1,0
GUA,Summer,2012,0,0,1,1,0
GUY,Summer,1980,1,0,0,1,328
HAI,Summer,1900,0,1,0,1,0
HAI,Summer,1924,5,0,0,5,0
HAI,Summer,1928,0,0,1,1,0
HKG,Summer,1996,0,1,0,1,0
HKG,Summer,2004,0,0,2,2,0
HKG,Summer,2012,1,0,0,1,0
HUN,Summer,1896,3,2,1,6,348
HUN,Summer,1900,2,1,2,5,348
HUN,Summer,1904,1,2,1,4,348
HUN,Summer,1906,3,5,5,13,348
HUN,Summer,1908,6,7,7,20,348
HUN,Summer,1912,3,10,17,30,348
HUN,Summer,1924,8,2,12,22,348
HUN,Summer,1928,0,10,11,21,348
HUN,Summer,1932,8,20,5,33,348
HUN,Summer,1936,15,25,1,41,348
HUN,Summer,1948,22,15,25,62,348
HUN,Summer,1952,32,53,17,102,348
HUN,Summer,1956,14,30,20,64,348
HUN,Summer,1960,37,13,16,66,348
HUN,Summer,1964,7,42,7,56,348
HUN,Summer,1968,29,32,20,81,348
HUN,Summer,1972,25,10,46,81,348
HUN,Summer,1976,35,14,6,55,348
HUN,Summer,1980,40,8,13,61,348
HUN,Summer,1988,15,20,9,44,348
HUN,Summer,1992,8,14,23,45,348
HUN,Summer,1996,26,8,9,43,348
HUN,Summer,2000,4,25,24,53,348
HUN,Summer,2004,4,24,12,40,348
HUN,Summer,2008,3,16,8,27,348
HUN,Summer,2012,6,12,8,26,348
HUN,Summer,2016,7,12,3,22,348
HUN,Winter,1932,2,0,0,2,348
HUN,Winter,1936,2,0,0,2,348
HUN,Winter,1948,0,0,2,2,348
HUN,Winter,1952,2,0,0,2,348
HUN,Winter,1956,2,0,0,2,348
HUN,Winter,1980,0,0,2,2,348
INA,Summer,1988,0,0,3,3,0
INA,Summer,1992,1,2,3,6,0
INA,Summer,1996,3,2,1,6,0
INA,Summer,2000,2,2,4,8,0
INA,Summer,2004,3,1,1,5,0
INA,Summer,2008,3,2,2,7,0
INA,Summer,2012,1,0,1,2,0
INA,Summer,2016,0,2,2,4,0
IND,Summer,1900,0,0,2,2,356
IND,Summer,1928,0,14,0,14,356
IND,Summer,1932,0,15,0,15,356
IND,Summer,1936,0,19,0,19,356
IND,Summer,1948,0,20,0,20,356
IND,Summer,1952,1,14,0,15,356
IND,Summer,1956,0,17,0,17,356
IND,Summer,1960,0,0,13,13,356
IND,Summer,1964,0,15,0,15,356
IND,Summer,1968,16,0,0,16,356
IND,Summer,1972,14,0,0,14,356
IND,Summer,1980,0,16,0,16,356
IND,Summer,1996,1,0,0,1,356
IND,Summer,2000,1,0,0,1,356
IND,Summer,2004,0,0,1,1,356
IND,Summer,2008,2,1,0,3,356
IND,Summer,2012,4,0,2,6,356
IND,Summer,2016,1,0,1,2,356
IND,Winter,1924,0,7,0,7,356
IOA,Summer,1992,2,0,1,3,0
IOA,Summer,2016,1,1,0,2,0
IRI,Summer,1948,1,0,0,1,0
IRI,Summer,1952,4,0,3,7,0
IRI,Summer,1956,1,2,2,5,0
IRI,Summer,1960,3,0,1,4,0
IRI,Summer,1964,2,0,0,2,0
IRI,Summer,1968,2,2,1,5,0
IRI,Summer,1972,1,0,2,3,0
IRI,Summer,1976,1,0,1,2,0
IRI,Summer,1988,0,0,1,1,0
IRI,Summer,1992,2,0,1,3,0
IRI,Summer,1996,1,1,1,3,0
IRI,Summer,2000,1,3,0,4,0
IRI,Summer,2004,2,2,2,6,0
IRI,Summer,2008,1,1,0,2,0
IRI,Summer,2012,3,4,5,12,0
IRI,Summer,2016,4,3,1,8,0
IRL,Summer,1924,1,0,1,2,372
IRL,Summer,1928,0,1,0,1,372
IRL,Summer,1932,0,2,0,2,372
IRL,Summer,1948,1,0,0,1,372
IRL,Summer,1952,0,0,1,1,372
IRL,Summer,1956,3,1,1,5,372
IRL,Summer,1964,1,0,0,1,372
IRL,Summer,1980,1,0,2,3,372
IRL,Summer,1984,0,0,1,1,372
IRL,Summer,1992,0,1,1,2,372
IRL,Summer,1996,1,3,0,4,372
IRL,Summer,2000,0,0,1,1,372
IRL,Summer,2008,2,0,1,3,372
IRL,Summer,2012,3,1,1,5,372
IRL,Summer,2016,0,0,3,3,372
IRQ,Summer,1960,1,0,0,1,368
ISL,Summer,1956,0,0,1,1,352
ISL,Summer,1984,1,0,0,1,352
ISL,Summer,2000,1,0,0,1,352
ISL,Summer,2008,0,0,14,14,352
ISR,Summer,1992,1,0,1,2,376
ISR,Summer,1996,1,0,0,1,376
ISR,Summer,2000,1,0,0,1,376
ISR,Summer,2004,1,1,0,2,376
ISR,Summer,2008,1,0,0,1,376
ISR,Summer,2016,2,0,0,2,376
ISV,Summer,1988,0,0,1,1,0
ITA,Summer,1900,0,3,2,5,380
ITA,Summer,1906,27,21,8,56,380
ITA,Summer,1908,0,2,6,8,380
ITA,Summer,1912,2,22,1,25,380
ITA,Summer,1920,8,67,9,84,380
ITA,Summer,1924,21,25,5,51,380
ITA,Summer,1928,26,24,22,72,380
ITA,Summer,1932,18,21,38,77,380
ITA,Summer,1936,5,37,34,76,380
ITA,Summer,1948,14,21,32,67,380
ITA,Summer,1952,15,17,22,54,380
ITA,Summer,1956,10,26,11,47,380
ITA,Summer,1960,34,36,18,88,380
ITA,Summer,1964,9,14,28,51,380
ITA,Summer,1968,20,5,8,33,380
ITA,Summer,1972,13,9,3,25,380
ITA,Summer,1976,4,2,25,31,380
ITA,Summer,1980,8,8,21,37,380
ITA,Summer,1984,28,29,6,63,380
ITA,Summer,1988,8,11,10,29,380
ITA,Summer,1992,14,21,10,45,380
ITA,Summer,1996,28,19,24,71,380
ITA,Summer,2000,29,22,14,65,380
ITA,Summer,2004,39,24,41,104,380
ITA,Summer,2008,20,8,14,42,380
ITA,Summer,2012,30,16,22,68,380
ITA,Summer,2016,24,8,40,72,380
ITA,Winter,1948,0,1,0,1,380
ITA,Winter,1952,1,1,0,2,380
ITA,Winter,1956,0,2,6,8,380
ITA,Winter,1960,1,0,0,1,380
ITA,Winter,1964,8,0,2,10,380
ITA,Winter,1968,0,8,0,8,380
ITA,Winter,1972,1,3,5,9,380
ITA,Winter,1976,1,1,2,4,380
ITA,Winter,1980,0,0,3,3,380
ITA,Winter,1984,0,2,0,2,380
ITA,Winter,1988,5,2,1,8,380
ITA,Winter,1992,8,4,9,21,380
ITA,Winter,1994,12,14,6,32,380
ITA,Winter,1998,5,3,9,17,380
ITA,Winter,2002,6,4,11,21,380
ITA,Winter,2006,14,11,0,25,380
ITA,Winter,2010,3,1,1,5,380
ITA,Winter,2014,12,0,2,14,380
JAM,Summer,1948,0,1,2,3,388
JAM,Summer,1952,0,5,3,8,388
JAM,Summer,1968,0,0,1,1,388
JAM,Summer,1972,1,0,0,1,388
JAM,Summer,1976,0,1,1,2,388
JAM,Summer,1980,3,0,0,3,388
JAM,Summer,1984,2,0,5,7,388
JAM,Summer,1988,0,0,7,7,388
JAM,Summer,1992,1,0,3,4,388
JAM,Summer,1996,12,1,3,16,388
JAM,Summer,2000,3,0,20,23,388
JAM,Summer,2004,6,6,1,13,388
JAM,Summer,2008,6,5,3,14,388
JAM,Summer,2012,8,8,9,25,388
JAM,Summer,2016,2,11,17,30,388
JOR,Summer,2016,0,1,0,1,400
JPN,Summer,1920,0,0,3,3,392
JPN,Summer,1924,1,0,0,1,392
JPN,Summer,1928,1,2,6,9,392
JPN,Summer,1932,4,10,17,31,392
JPN,Summer,1936,10,9,4,23,392
JPN,Summer,1952,2,1,9,12,392
JPN,Summer,1956,5,4,15,24,392
JPN,Summer,1960,12,9,10,31,392
JPN,Summer,1964,25,32,5,62,392
JPN,Summer,1968,22,16,25,63,392
JPN,Summer,1972,8,29,19,56,392
JPN,Summer,1976,10,25,6,41,392
JPN,Summer,1984,31,10,8,49,392
JPN,Summer,1988,13,4,3,20,392
JPN,Summer,1992,36,3,8,47,392
JPN,Summer,1996,13,3,26,42,392
JPN,Summer,2000,8,5,31,44,392
JPN,Summer,2004,52,21,20,93,392
JPN,Summer,2008,13,23,15,51,392
JPN,Summer,2012,33,7,44,84,392
JPN,Summer,2016,34,17,13,64,392
JPN,Winter,1956,0,0,1,1,392
JPN,Winter,1972,1,1,1,3,392
JPN,Winter,1980,0,0,1,1,392
JPN,Winter,1984,0,0,1,1,392
JPN,Winter,1988,1,0,0,1,392
JPN,Winter,1992,7,3,2,12,392
JPN,Winter,1994,2,3,5,10,392
JPN,Winter,1998,4,8,1,13,392
JPN,Winter,2002,1,0,1,2,392
JPN,Winter,2006,0,1,0,1,392
JPN,Winter,2010,2,0,5,7,392
JPN,Winter,2014,6,1,4,11,392
KAZ,Summer,1996,4,3,4,11,398
KAZ,Summer,2000,0,3,4,7,398
KAZ,Summer,2004,3,1,4,8,398
KAZ,Summer,2008,7,2,4,13,398
KAZ,Summer,2012,5,7,1,13,398
KAZ,Summer,2016,10,3,5,18,398
KAZ,Winter,1994,0,1,2,3,398
KAZ,Winter,1998,2,0,0,2,398
KAZ,Winter,2010,0,0,1,1,398
KAZ,Winter,2014,1,0,0,1,398
KEN,Summer,1964,1,0,0,1,404
KEN,Summer,1968,2,3,7,12,404
KEN,Summer,1972,4,5,3,12,404
KEN,Summer,1984,2,1,0,3,404
KEN,Summer,1988,2,5,2,9,404
KEN,Summer,1992,2,2,4,8,404
KEN,Summer,1996,3,1,4,8,404
KEN,Summer,2000,2,2,3,7,404
KEN,Summer,2004,2,1,4,7,404
KEN,Summer,2008,5,6,4,15,404
KEN,Summer,2012,5,2,4,11,404
KEN,Summer,2016,1,6,6,13,404
KGZ,Summer,2000,1,0,0,1,417
KGZ,Summer,2008,1,0,1,2,417
KOR,Summer,1948,2,0,0,2,410
KOR,Summer,1952,2,0,0,2,410
KOR,Summer,1956,1,0,1,2,410
KOR,Summer,1964,1,0,2,3,410
KOR,Summer,1968,1,0,1,2,410
KOR,Summer,1972,0,0,1,1,410
KOR,Summer,1976,15,1,1,17,410
KOR,Summer,1984,7,6,28,41,410
KOR,Summer,1988,12,28,37,77,410
KOR,Summer,1992,16,28,5,49,410
KOR,Summer,1996,7,10,49,66,410
KOR,Summer,2000,35,12,26,73,410
KOR,Summer,2004,10,14,28,52,410
KOR,Summer,2008,26,41,11,78,410
KOR,Summer,2012,30,18,13,61,410
KOR,Summer,2016,10,13,3,26,410
KOR,Winter,1992,1,5,1,7,410
KOR,Winter,1994,1,7,1,9,410
KOR,Winter,1998,2,6,4,12,410
KOR,Winter,2002,0,5,2,7,410
KOR,Winter,2006,2,14,3,19,410
KOR,Winter,2010,2,6,10,18,410
KOR,Winter,2014,2,7,5,14,410
KOS,Summer,2016,0,1,0,1,0
KSA,Summer,2000,1,0,1,2,0
KSA,Summer,2012,4,0,0,4,0
KUW,Summer,2000,1,0,0,1,0
KUW,Summer,2012,1,0,0,1,0
LAT,Summer,1932,0,0,1,1,0
LAT,Summer,1936,1,0,1,2,0
LAT,Summer,1992,1,0,2,3,0
LAT,Summer,1996,0,0,1,1,0
LAT,Summer,2000,1,1,1,3,0
LAT,Summer,2004,0,0,4,4,0
LAT,Summer,2008,1,1,1,3,0
LAT,Summer,2012,2,1,0,3,0
LAT,Winter,2006,1,0,0,1,0
LAT,Winter,2010,0,0,3,3,0
LAT,Winter,2014,6,0,5,11,0
LIB,Summer,1952,1,0,1,2,0
LIB,Summer,1972,0,0,1,1,0
LIB,Summer,1980,1,0,0,1,0
LIE,Winter,1976,2,0,0,2,0
LIE,Winter,1980,0,2,2,4,0
LIE,Winter,1984,2,0,0,2,0
LIE,Winter,1988,1,0,0,1,0
LTU,Summer,1992,12,1,0,13,440
LTU,Summer,1996,11,0,0,11,440
LTU,Summer,2000,15,2,0,17,440
LTU,Summer,2004,0,1,2,3,440
LTU,Summer,2008,3,0,2,5,440
LTU,Summer,2012,2,2,1,5,440
LTU,Summer,2016,5,0,2,7,440
LUX,Summer,1900,0,1,0,1,442
LUX,Summer,1920,0,0,1,1,442
LUX,Summer,1924,0,1,1,2,442
LUX,Summer,1928,0,1,0,1,442
LUX,Summer,1952,0,1,0,1,442
LUX,Winter,1992,0,0,2,2,442
MAR,Summer,1960,0,0,1,1,504
MAR,Summer,1984,0,2,0,2,504
MAR,Summer,1988,2,1,0,3,504
MAR,Summer,1992,1,1,1,3,504
MAR,Summer,1996,2,0,0,2,504
MAR,Summer,2000,4,0,1,5,504
MAR,Summer,2004,0,2,1,3,504
MAR,Summer,2008,1,0,1,2,504
MAR,Summer,2012,1,0,0,1,504
MAR,Summer,2016,1,0,0,1,504
MAS,Summer,1992,2,0,0,2,0
MAS,Summer,1996,1,0,2,3,0
MAS,Summer,2008,0,0,1,1,0
MAS,Summer,2012,1,0,1,2,0
MAS,Summer,2016,1,0,7,8,0
MDA,Summer,1996,1,0,2,3,498
MDA,Summer,2000,1,0,1,2,498
MDA,Summer,2008,1,0,0,1,498
MDA,Summer,2012,2,0,0,2,498
MEX,Summer,1900,3,0,0,3,484
MEX,Summer,1932,0,0,2,2,484
MEX,Summer,1936,16,0,0,16,484
MEX,Summer,1948,4,4,1,9,484
MEX,Summer,1952,0,0,1,1,484
MEX,Summer,1956,1,1,0,2,484
MEX,Summer,1960,1,0,0,1,484
MEX,Summer,1964,1,0,0,1,484
MEX,Summer,1968,3,3,3,9,484
MEX,Summer,1972,0,0,1,1,484
MEX,Summer,1976,1,1,0,2,484
MEX,Summer,1980,9,0,1,10,484
MEX,Summer,1984,1,2,3,6,484
MEX,Summer,1988,2,0,0,2,484
MEX,Summer,1992,0,0,1,1,484
MEX,Summer,1996,1,0,0,1,484
MEX,Summer,2000,3,1,2,6,484
MEX,Summer,2004,1,0,3,4,484
MEX,Summer,2008,2,2,0,4,484
MEX,Summer,2012,3,16,5,24,484
MEX,Summer,2016,2,0,3,5,484
MGL,Summer,1968,3,0,1,4,0
MGL,Summer,1972,0,0,1,1,0
MGL,Summer,1976,0,0,1,1,0
MGL,Summer,1980,2,0,2,4,0
MGL,Summer,1988,1,0,0,1,0
MGL,Summer,1992,2,0,0,2,0
MGL,Summer,1996,1,0,0,1,0
MGL,Summer,2004,1,0,0,1,0
MGL,Summer,2008,0,2,2,4,0
MGL,Summer,2012,3,0,2,5,0
MGL,Summer,2016,1,0,1,2,0
MKD,Summer,2000,1,0,0,1,807
MNE,Summer,2012,0,0,14,14,499
MON,Summer,1924,1,0,0,1,0
MOZ,Summer,1996,1,0,0,1,508
MOZ,Summer,2000,0,1,0,1,508
MRI,Summer,2008,1,0,0,1,0
NAM,Summer,1992,0,0,2,2,516
NAM,Summer,1996,0,0,2,2,516
NED,Summer,1900,16,3,8,27,0
NED,Summer,1906,5,0,1,6,0
NED,Summer,1908,16,0,0,16,0
NED,Summer,1912,26,0,0,26,0
NED,Summer,1920,25,15,10,50,0
NED,Summer,1924,18,8,1,27,0
NED,Summer,1928,8,20,29,57,0
NED,Summer,1932,1,2,10,13,0
NED,Summer,1936,21,9,7,37,0
NED,Summer,1948,32,8,2,42,0
NED,Summer,1952,0,0,18,18,0
NED,Summer,1960,2,0,1,3,0
NED,Summer,1964,16,5,10,31,0
NED,Summer,1968,1,6,7,14,0
NED,Summer,1972,2,3,1,6,0
NED,Summer,1976,12,0,2,14,0
NED,Summer,1980,5,0,1,6,0
NED,Summer,1984,14,20,7,41,0
NED,Summer,1988,36,3,6,45,0
NED,Summer,1992,8,5,20,33,0
NED,Summer,1996,26,38,9,73,0
NED,Summer,2000,23,27,29,79,0
NED,Summer,2004,22,4,51,77,0
NED,Summer,2008,4,39,18,61,0
NED,Summer,2012,19,21,29,69,0
NED,Summer,2016,13,9,25,47,0
NED,Winter,1952,0,0,3,3,0
NED,Winter,1960,1,0,1,2,0
NED,Winter,1964,0,1,1,2,0
NED,Winter,1968,3,3,3,9,0
NED,Winter,1972,2,4,3,9,0
NED,Winter,1976,3,1,2,6,0
NED,Winter,1980,1,1,2,4,0
NED,Winter,1988,2,3,2,7,0
NED,Winter,1992,2,1,1,4,0
NED,Winter,1994,3,0,1,4,0
NED,Winter,1998,2,5,4,11,0
NED,Winter,2002,0,3,5,8,0
NED,Winter,2006,8,3,2,13,0
NED,Winter,2010,6,4,1,11,0
NED,Winter,2014,9,13,7,29,0
NEP,Winter,1924,0,1,0,1,0
NGR,Summer,1964,1,0,0,1,0
NGR,Summer,1972,1,0,0,1,0
NGR,Summer,1984,4,0,1,5,0
NGR,Summer,1992,4,0,7,11,0
NGR,Summer,1996,3,17,4,24,0
NGR,Summer,2000,0,6,2,8,0
NGR,Summer,2004,8,0,0,8,0
NGR,Summer,2008,7,0,16,23,0
NGR,Summer,2016,18,0,0,18,0
NIG,Summer,1972,1,0,0,1,0
NIG,Summer,2016,0,0,1,1,0
NOR,Summer,1900,3,0,6,9,578
NOR,Summer,1904,0,2,0,2,578
NOR,Summer,1906,0,20,5,25,578
NOR,Summer,1908,3,7,32,42,578
NOR,Summer,1912,34,40,6,80,578
NOR,Summer,1920,27,58,52,137,578
NOR,Summer,1924,3,14,5,22,578
NOR,Summer,1928,1,4,4,9,578
NOR,Summer,1936,15,1,12,28,578
NOR,Summer,1948,11,3,4,18,578
NOR,Summer,1952,0,5,8,13,578
NOR,Summer,1956,2,1,0,3,578
NOR,Summer,1960,0,2,0,2,578
NOR,Summer,1968,0,4,2,6,578
NOR,Summer,1972,4,2,2,8,578
NOR,Summer,1976,0,2,4,6,578
NOR,Summer,1984,3,0,1,4,578
NOR,Summer,1988,0,2,20,22,578
NOR,Summer,1992,1,2,20,23,578
NOR,Summer,1996,18,2,3,23,578
NOR,Summer,2000,19,20,4,43,578
NOR,Summer,2004,2,5,0,7,578
NOR,Summer,2008,1,16,5,22,578
NOR,Summer,2012,1,15,1,17,578
NOR,Summer,2016,19,0,0,19,578
NOR,Winter,1924,6,4,7,17,578
NOR,Winter,1928,5,6,4,15,578
NOR,Winter,1932,3,3,4,10,578
NOR,Winter,1936,3,7,8,18,578
NOR,Winter,1948,6,4,3,13,578
NOR,Winter,1952,6,7,6,19,578
NOR,Winter,1956,1,2,1,4,578
NOR,Winter,1960,0,3,6,9,578
NOR,Winter,1964,6,3,6,15,578
NOR,Winter,1968,2,11,9,22,578
NOR,Winter,1972,7,2,8,17,578
NOR,Winter,1976,1,3,6,10,578
NOR,Winter,1980,9,1,5,15,578
NOR,Winter,1984,4,6,5,15,578
NOR,Winter,1988,5,0,6,11,578
NOR,Winter,1992,5,9,10,24,578
NOR,Winter,1994,5,8,17,30,578
NOR,Winter,1998,12,13,15,40,578
NOR,Winter,2002,7,23,11,41,578
NOR,Winter,2006,12,2,9,23,578
NOR,Winter,2010,9,16,14,39,578
NOR,Winter,2014,13,18,5,36,578
NZL,Summer,1900,0,1,0,1,554
NZL,Summer,1920,1,0,0,1,554
NZL,Summer,1924,1,0,0,1,554
NZL,Summer,1928,0,1,0,1,554
NZL,Summer,1932,0,0,2,2,554
NZL,Summer,1936,0,1,0,1,554
NZL,Summer,1952,2,1,0,3,554
NZL,Summer,1956,0,3,0,3,554
NZL,Summer,1960,1,2,0,3,554
NZL,Summer,1964,2,4,0,6,554
NZL,Summer,1968,2,5,0,7,554
NZL,Summer,1972,1,9,4,14,554
NZL,Summer,1976,9,15,1,25,554
NZL,Summer,1984,6,16,1,23,554
NZL,Summer,1988,16,4,4,24,554
NZL,Summer,1992,5,1,9,15,554
NZL,Summer,1996,4,3,2,9,554
NZL,Summer,2000,3,1,0,4,554
NZL,Summer,2004,0,4,2,6,554
NZL,Summer,2008,9,4,2,15,554
NZL,Summer,2012,15,9,3,27,554
NZL,Summer,2016,5,6,25,36,554
NZL,Winter,1992,0,0,1,1,554
PAK,Summer,1956,0,0,14,14,586
PAK,Summer,1960,1,13,0,14,586
PAK,Summer,1964,0,0,16,16,586
PAK,Summer,1968,0,13,0,13,586
PAK,Summer,1972,0,0,15,15,586
PAK,Summer,1976,16,0,0,16,586
PAK,Summer,1984,0,16,0,16,586
PAK,Summer,1988,1,0,0,1,586
PAK,Summer,1992,16,0,0,16,586
PAN,Summer,1948,2,0,0,2,591
PAN,Summer,2008,0,1,0,1,591
PAR,Summer,2004,0,0,17,17,0
PER,Summer,1948,0,1,0,1,604
PER,Summer,1984,0,0,1,1,604
PER,Summer,1988,0,0,12,12,604
PER,Summer,1992,0,0,1,1,604
PHI,Summer,1928,1,0,0,1,0
PHI,Summer,1932,3,0,0,3,0
PHI,Summer,1936,1,0,0,1,0
PHI,Summer,1964,0,0,1,1,0
PHI,Summer,1988,1,0,0,1,0
PHI,Summer,1992,1,0,0,1,0
PHI,Summer,1996,0,0,1,1,0
PHI,Summer,2016,0,0,1,1,0
POL,Summer,1924,1,0,4,5,616
POL,Summer,1928,15,2,3,20,616
POL,Summer,1932,14,3,4,21,616
POL,Summer,1936,6,0,6,12,616
POL,Summer,1948,1,1,0,2,616
POL,Summer,1952,1,1,2,4,616
POL,Summer,1956,9,1,9,19,616
POL,Summer,1960,15,4,11,30,616
POL,Summer,1964,23,10,13,46,616
POL,Summer,1968,30,5,2,37,616
POL,Summer,1972,11,27,8,46,616
POL,Summer,1976,26,18,29,73,616
POL,Summer,1980,22,3,25,50,616
POL,Summer,1988,10,2,9,21,616
POL,Summer,1992,19,5,22,46,616
POL,Summer,1996,7,7,8,22,616
POL,Summer,2000,7,7,10,24,616
POL,Summer,2004,6,4,2,12,616
POL,Summer,2008,1,6,13,20,616
POL,Summer,2012,8,2,2,12,616
POL,Summer,2016,10,3,3,16,616
POL,Winter,1956,1,0,0,1,616
POL,Winter,1960,1,0,1,2,616
POL,Winter,1972,0,1,0,1,616
POL,Winter,2002,1,0,1,2,616
POL,Winter,2006,1,0,1,2,616
POL,Winter,2010,4,1,3,8,616
POL,Winter,2014,3,4,4,11,616
POR,Summer,1924,4,0,0,4,0
POR,Summer,1928,6,0,0,6,0
POR,Summer,1936,3,0,0,3,0
POR,Summer,1948,3,0,2,5,0
POR,Summer,1952,2,0,0,2,0
POR,Summer,1960,0,0,2,2,0
POR,Summer,1976,0,0,2,2,0
POR,Summer,1984,2,1,0,3,0
POR,Summer,1988,0,1,0,1,0
POR,Summer,1996,2,1,0,3,0
POR,Summer,2000,2,0,0,2,0
POR,Summer,2004,1,0,2,3,0
POR,Summer,2008,0,1,1,2,0
POR,Summer,2012,0,0,2,2,0
POR,Summer,2016,1,0,0,1,0
PRK,Summer,1972,13,1,1,15,408
PRK,Summer,1976,0,1,1,2,408
PRK,Summer,1980,2,0,3,5,408
PRK,Summer,1992,6,4,0,10,408
PRK,Summer,1996,2,2,1,5,408
PRK,Summer,2000,3,0,1,4,408
PRK,Summer,2004,1,0,4,5,408
PRK,Summer,2008,3,2,1,6,408
PRK,Summer,2012,2,4,0,6,408
PRK,Summer,2016,2,2,3,7,408
PRK,Winter,1964,0,0,1,1,408
PRK,Winter,1992,1,0,0,1,408
PUR,Summer,1948,1,0,0,1,0
PUR,Summer,1976,1,0,0,1,0
PUR,Summer,1984,1,0,1,2,0
PUR,Summer,1992,1,0,0,1,0
PUR,Summer,1996,1,0,0,1,0
PUR,Summer,2012,1,0,1,2,0
PUR,Summer,2016,0,1,0,1,0
QAT,Summer,1992,1,0,0,1,634
QAT,Summer,2000,1,0,0,1,634
QAT,Summer,2012,2,0,0,2,634
QAT,Summer,2016,0,0,1,1,634
ROU,Summer,1924,16,0,0,16,642
ROU,Summer,1936,0,0,1,1,642
ROU,Summer,1952,2,1,1,4,642
ROU,Summer,1956,10,6,3,19,642
ROU,Summer,1960,11,3,1,15,642
ROU,Summer,1964,10,2,4,16,642
ROU,Summer,1968,9,5,9,23,642
ROU,Summer,1972,27,3,10,40,642
ROU,Summer,1976,23,4,28,55,642
ROU,Summer,1980,46,7,15,68,642
ROU,Summer,1984,35,40,31,106,642
ROU,Summer,1988,16,8,34,58,642
ROU,Summer,1992,14,8,31,53,642
ROU,Summer,1996,15,13,10,38,642
ROU,Summer,2000,13,27,6,46,642
ROU,Summer,2004,11,23,5,39,642
ROU,Summer,2008,16,5,1,22,642
ROU,Summer,2012,6,2,8,16,642
ROU,Summer,2016,10,4,2,16,642
ROU,Winter,1968,2,0,0,2,642
RSA,Summer,1908,0,1,1,2,0
RSA,Summer,1912,0,5,2,7,0
RSA,Summer,1920,6,3,12,21,0
RSA,Summer,1924,1,1,1,3,0
RSA,Summer,1928,5,1,0,6,0
RSA,Summer,1932,3,2,0,5,0
RSA,Summer,1936,0,0,1,1,0
RSA,Summer,1948,2,2,2,6,0
RSA,Summer,1952,4,2,8,14,0
RSA,Summer,1956,7,0,0,7,0
RSA,Summer,1960,2,0,1,3,0
RSA,Summer,1992,0,0,3,3,0
RSA,Summer,1996,1,3,1,5,0
RSA,Summer,2000,3,0,2,5,0
RSA,Summer,2004,3,4,3,10,0
RSA,Summer,2008,0,0,1,1,0
RSA,Summer,2012,1,6,2,9,0
RSA,Summer,2016,14,2,7,23,0
RUS,Summer,1908,0,1,2,3,643
RUS,Summer,1912,9,0,5,14,643
RUS,Summer,1996,34,36,45,115,643
RUS,Summer,2000,54,66,67,187,643
RUS,Summer,2004,95,48,46,189,643
RUS,Summer,2008,53,43,46,142,643
RUS,Summer,2012,51,50,39,140,643
RUS,Summer,2016,35,52,28,115,643
RUS,Winter,1994,4,19,13,36,643
RUS,Winter,1998,6,14,32,52,643
RUS,Winter,2002,27,6,5,38,643
RUS,Winter,2006,13,16,12,41,643
RUS,Winter,2010,14,6,5,25,643
RUS,Winter,2014,13,33,22,68,643
SCG,Summer,1996,13,1,12,26,0
SCG,Summer,2000,13,11,1,25,0
SCG,Summer,2004,0,0,13,13,0
SEN,Summer,1988,0,0,1,1,686
SGP,Summer,1960,0,0,1,1,0
SGP,Summer,2008,0,0,3,3,0
SGP,Summer,2012,4,0,0,4,0
SGP,Summer,2016,0,1,0,1,0
SLO,Summer,1992,6,0,0,6,0
SLO,Summer,1996,0,0,2,2,0
SLO,Summer,2000,0,3,0,3,0
SLO,Summer,2004,3,0,2,5,0
SLO,Summer,2008,2,1,2,5,0
SLO,Summer,2012,3,1,1,5,0
SLO,Summer,2016,1,1,2,4,0
SLO,Winter,1994,3,0,0,3,0
SLO,Winter,2002,4,0,0,4,0
SLO,Winter,2010,1,0,2,3,0
SLO,Winter,2014,4,2,2,8,0
SRB,Summer,2008,14,0,1,15,688
SRB,Summer,2012,14,1,1,16,688
SRB,Summer,2016,13,14,27,54,688
SRI,Summer,1948,0,0,1,1,0
SRI,Summer,2000,0,0,1,1,0
SUD,Summer,2008,0,0,1,1,0
SUI,Summer,1896,0,1,2,3,0
SUI,Summer,1900,1,16,4,21,0
SUI,Summer,1904,2,1,0,3,0
SUI,Summer,1906,1,8,3,12,0
SUI,Summer,1912,0,2,0,2,0
SUI,Summer,1920,21,6,2,29,0
SUI,Summer,1924,21,14,25,60,0
SUI,Summer,1928,4,16,10,30,0
SUI,Summer,1932,0,0,1,1,0
SUI,Summer,1936,24,5,23,52,0
SUI,Summer,1948,6,5,25,36,0
SUI,Summer,1952,12,2,19,33,0
SUI,Summer,1956,3,0,0,3,0
SUI,Summer,1960,6,0,6,12,0
SUI,Summer,1964,1,1,4,6,0
SUI,Summer,1968,10,0,3,13,0
SUI,Summer,1972,0,0,8,8,0
SUI,Summer,1976,6,1,3,10,0
SUI,Summer,1980,0,2,0,2,0
SUI,Summer,1984,4,0,9,13,0
SUI,Summer,1988,2,0,6,8,0
SUI,Summer,1992,0,1,0,1,0
SUI,Summer,1996,0,5,6,11,0
SUI,Summer,2000,2,1,11,14,0
SUI,Summer,2004,4,1,2,7,0
SUI,Summer,2008,7,3,1,11,0
SUI,Summer,2012,0,2,2,4,0
SUI,Summer,2016,2,6,3,11,0
SUI,Winter,1924,1,8,0,9,0
SUI,Winter,1928,12,0,0,12,0
SUI,Winter,1932,0,0,2,2,0
SUI,Winter,1936,0,4,6,10,0
SUI,Winter,1948,19,4,5,28,0
SUI,Winter,1952,6,0,0,6,0
SUI,Winter,1956,2,6,2,10,0
SUI,Winter,1960,0,2,0,2,0
SUI,Winter,1968,7,0,2,9,0
SUI,Winter,1972,7,7,3,17,0
SUI,Winter,1976,2,1,6,9,0
SUI,Winter,1980,3,2,4,9,0
SUI,Winter,1984,4,2,2,8,0
SUI,Winter,1988,5,8,7,20,0
SUI,Winter,1992,5,2,0,7,0
SUI,Winter,1994,4,4,8,16,0
SUI,Winter,1998,3,6,5,14,0
SUI,Winter,2002,14,3,7,24,0
SUI,Winter,2006,9,5,7,21,0
SUI,Winter,2010,6,6,0,12,0
SUI,Winter,2014,20,6,4,30,0
SUR,Summer,1988,0,1,0,1,740
SUR,Summer,1992,1,0,0,1,740
SVK,Summer,1996,1,1,1,3,703
SVK,Summer,2000,1,2,3,6,703
SVK,Summer,2004,5,3,2,10,703
SVK,Summer,2008,1,4,5,10,703
SVK,Summer,2012,4,0,1,5,703
SVK,Summer,2016,0,3,5,8,703
SVK,Winter,2006,0,0,1,1,703
SVK,Winter,2010,1,1,1,3,703
SVK,Winter,2014,0,1,0,1,703
SWE,Summer,1900,1,3,0,4,752
SWE,Summer,1906,14,2,5,21,752
SWE,Summer,1908,18,48,18,84,752
SWE,Summer,1912,25,103,62,190,752
SWE,Summer,1920,64,52,38,154,752
SWE,Summer,1924,43,7,22,72,752
SWE,Summer,1928,22,7,8,37,752
SWE,Summer,1932,12,13,7,32,752
SWE,Summer,1936,17,7,11,35,752
SWE,Summer,1948,30,30,15,75,752
SWE,Summer,1952,23,23,24,70,752
SWE,Summer,1956,6,14,14,34,752
SWE,Summer,1960,3,2,2,7,752
SWE,Summer,1964,8,3,4,15,752
SWE,Summer,1968,1,4,4,9,752
SWE,Summer,1972,8,4,10,22,752
SWE,Summer,1976,0,9,1,10,752
SWE,Summer,1980,9,3,8,20,752
SWE,Summer,1984,13,3,18,34,752
SWE,Summer,1988,11,0,5,16,752
SWE,Summer,1992,7,1,27,35,752
SWE,Summer,1996,5,3,23,31,752
SWE,Summer,2000,8,4,20,32,752
SWE,Summer,2004,2,5,5,12,752
SWE,Summer,2008,2,0,5,7,752
SWE,Summer,2012,3,2,17,22,752
SWE,Summer,2016,3,2,23,28,752
SWE,Winter,1924,0,1,8,9,752
SWE,Winter,1928,1,2,13,16,752
SWE,Winter,1932,0,1,2,3,752
SWE,Winter,1936,6,2,2,10,752
SWE,Winter,1948,3,7,3,13,752
SWE,Winter,1952,23,0,0,23,752
SWE,Winter,1956,9,2,4,15,752
SWE,Winter,1960,2,5,2,9,752
SWE,Winter,1964,1,6,21,28,752
SWE,Winter,1968,6,3,7,16,752
SWE,Winter,1972,2,1,1,4,752
SWE,Winter,1976,2,0,0,2,752
SWE,Winter,1980,20,3,0,23,752
SWE,Winter,1984,21,7,2,30,752
SWE,Winter,1988,23,7,0,30,752
SWE,Winter,1992,6,1,0,7,752
SWE,Winter,1994,0,23,1,24,752
SWE,Winter,1998,5,0,2,7,752
SWE,Winter,2002,24,0,2,26,752
SWE,Winter,2006,8,35,21,64,752
SWE,Winter,2010,4,11,3,18,752
SWE,Winter,2014,11,8,32,51,752
SYR,Summer,1984,0,0,1,1,760
SYR,Summer,1996,0,1,0,1,760
SYR,Summer,2004,1,0,0,1,760
TAN,Summer,1980,0,0,2,2,0
TCH,Summer,1920,10,0,0,10,0
TCH,Summer,1924,5,1,4,10,0
TCH,Summer,1928,2,2,12,16,0
TCH,Summer,1932,2,1,3,6,0
TCH,Summer,1936,1,5,12,18,0
TCH,Summer,1948,3,14,3,20,0
TCH,Summer,1952,10,11,4,25,0
TCH,Summer,1956,1,1,5,7,0
TCH,Summer,1960,11,4,7,22,0
TCH,Summer,1964,12,5,37,54,0
TCH,Summer,1968,15,7,7,29,0
TCH,Summer,1972,6,2,21,29,0
TCH,Summer,1976,9,2,4,15,0
TCH,Summer,1980,16,17,18,51,0
TCH,Summer,1988,3,3,4,10,0
TCH,Summer,1992,1,4,3,8,0
TCH,Winter,1928,1,0,0,1,0
TCH,Winter,1948,0,0,17,17,0
TCH,Winter,1960,0,0,1,1,0
TCH,Winter,1964,17,0,0,17,0
TCH,Winter,1968,1,1,19,21,0
TCH,Winter,1972,19,1,0,20,0
TCH,Winter,1976,0,0,19,19,0
TCH,Winter,1980,1,0,0,1,0
TCH,Winter,1984,4,0,24,28,0
TCH,Winter,1988,5,0,1,6,0
TCH,Winter,1992,27,0,0,27,0
TGA,Summer,1996,0,0,1,1,0
THA,Summer,1976,1,0,0,1,764
THA,Summer,1984,0,0,1,1,764
THA,Summer,1988,1,0,0,1,764
THA,Summer,1992,1,0,0,1,764
THA,Summer,1996,1,1,0,2,764
THA,Summer,2000,2,1,0,3,764
THA,Summer,2004,4,3,1,8,764
THA,Summer,2008,0,2,2,4,764
THA,Summer,2012,1,0,2,3,764
THA,Summer,2016,2,2,2,6,764
TJK,Summer,2008,1,0,1,2,762
TJK,Summer,2012,1,0,0,1,762
TJK,Summer,2016,0,1,0,1,762
TOG,Summer,2008,1,0,0,1,0
TPE,Summer,1960,0,0,1,1,0
TPE,Summer,1968,1,0,0,1,0
TPE,Summer,1984,1,0,0,1,0
TPE,Summer,1992,0,0,20,20,0
TPE,Summer,1996,0,0,1,1,0
TPE,Summer,2000,4,0,1,5,0
TPE,Summer,2004,3,2,4,9,0
TPE,Summer,2008,4,0,0,4,0
TPE,Summer,2012,1,0,1,2,0
TPE,Summer,2016,4,1,0,5,0
TTO,Summer,1948,0,0,1,1,780
TTO,Summer,1952,2,0,0,2,780
TTO,Summer,1964,5,0,1,6,780
TTO,Summer,1976,0,1,0,1,780
TTO,Summer,1996,2,0,0,2,780
TTO,Summer,2000,1,0,1,2,780
TTO,Summer,2004,1,0,0,1,780
TTO,Summer,2008,0,5,1,6,780
TTO,Summer,2012,5,1,4,10,780
TTO,Summer,2016,1,0,0,1,780
TUN,Summer,1964,1,0,1,2,788
TUN,Summer,1968,1,1,0,2,788
TUN,Summer,1972,0,0,1,1,788
TUN,Summer,1996,1,0,0,1,788
TUN,Summer,2008,0,1,0,1,788
TUN,Summer,2012,1,1,1,3,788
TUN,Summer,2016,3,0,0,3,788
TUR,Summer,1936,1,1,0,2,792
TUR,Summer,1948,2,6,4,12,792
TUR,Summer,1952,1,2,0,3,792
TUR,Summer,1956,2,3,2,7,792
TUR,Summer,1960,0,7,2,9,792
TUR,Summer,1964,1,2,3,6,792
TUR,Summer,1968,0,2,0,2,792
TUR,Summer,1972,0,0,1,1,792
TUR,Summer,1984,3,0,0,3,792
TUR,Summer,1988,0,1,1,2,792
TUR,Summer,1992,2,2,2,6,792
TUR,Summer,1996,1,4,1,6,792
TUR,Summer,2000,2,3,0,5,792
TUR,Summer,2004,5,3,3,11,792
TUR,Summer,2008,3,1,3,7,792
TUR,Summer,2012,1,2,2,5,792
TUR,Summer,2016,4,1,3,8,792
UAE,Summer,2004,0,1,0,1,0
UAE,Summer,2016,1,0,0,1,0
UAR,Summer,1960,1,0,1,2,0
UGA,Summer,1968,1,0,1,2,800
UGA,Summer,1972,0,1,1,2,800
UGA,Summer,1980,0,0,1,1,800
UGA,Summer,1996,1,0,0,1,800
UGA,Summer,2012,0,1,0,1,800
UKR,Summer,1996,19,10,5,34,804
UKR,Summer,2000,12,3,20,35,804
UKR,Summer,2004,31,8,8,47,804
UKR,Summer,2008,16,10,5,31,804
UKR,Summer,2012,12,9,5,26,804
UKR,Summer,2016,5,2,8,15,804
UKR,Winter,1994,1,1,0,2,804
UKR,Winter,1998,0,0,1,1,804
UKR,Winter,2006,3,0,0,3,804
UKR,Winter,2014,1,4,0,5,804
URS,Summer,1952,19,36,62,117,0
URS,Summer,1956,55,68,46,169,0
URS,Summer,1960,45,61,63,169,0
URS,Summer,1964,51,60,63,174,0
URS,Summer,1968,64,65,63,192,0
URS,Summer,1972,60,107,47,214,0
URS,Summer,1976,77,114,95,286,0
URS,Summer,1980,126,187,129,442,0
URS,Summer,1988,99,134,67,300,0
URS,Winter,1956,6,26,5,37,0
URS,Winter,1960,28,7,7,42,0
URS,Winter,1964,9,30,8,47,0
URS,Winter,1968,5,26,6,37,0
URS,Winter,1972,3,36,6,45,0
URS,Winter,1976,11,38,7,56,0
URS,Winter,1980,7,18,29,54,0
URS,Winter,1984,12,29,15,56,0
URS,Winter,1988,12,40,14,66,0
URU,Summer,1924,0,14,0,14,0
URU,Summer,1928,0,17,0,17,0
URU,Summer,1932,1,0,0,1,0
URU,Summer,1948,2,0,1,3,0
URU,Summer,1952,14,0,0,14,0
URU,Summer,1956,12,0,0,12,0
URU,Summer,1964,1,0,0,1,0
URU,Summer,2000,0,0,1,1,0
USA,Summer,1896,2,11,7,20,840
USA,Summer,1900,17,30,16,63,840
USA,Summer,1904,125,128,141,394,840
USA,Summer,1906,6,12,6,24,840
USA,Summer,1908,15,34,16,65,840
USA,Summer,1912,36,46,25,107,840
USA,Summer,1920,38,111,45,194,840
USA,Summer,1924,49,97,36,182,840
USA,Summer,1928,17,47,24,88,840
USA,Summer,1932,61,81,47,189,840
USA,Summer,1936,16,51,29,96,840
USA,Summer,1948,35,87,30,152,840
USA,Summer,1952,28,83,23,134,840
USA,Summer,1956,20,61,42,123,840
USA,Summer,1960,21,81,23,125,840
USA,Summer,1964,37,95,37,169,840
USA,Summer,1968,35,99,32,166,840
USA,Summer,1972,43,69,59,171,840
USA,Summer,1976,36,70,58,164,840
USA,Summer,1984,50,186,116,352,840
USA,Summer,1988,54,87,66,207,840
USA,Summer,1992,85,89,50,224,840
USA,Summer,1996,52,159,48,259,840
USA,Summer,2000,51,130,61,242,840
USA,Summer,2004,71,117,75,263,840
USA,Summer,2008,80,127,110,317,840
USA,Summer,2012,46,145,57,248,840
USA,Summer,2016,71,139,54,264,840
USA,Winter,1924,1,1,10,12,840
USA,Winter,1928,2,6,6,14,840
USA,Winter,1932,3,10,21,34,840
USA,Winter,1936,14,2,0,16,840
USA,Winter,1948,6,6,4,16,840
USA,Winter,1952,1,4,25,30,840
USA,Winter,1956,5,2,19,26,840
USA,Winter,1960,4,19,4,27,840
USA,Winter,1964,5,1,2,8,840
USA,Winter,1968,1,1,5,7,840
USA,Winter,1972,3,3,18,24,840
USA,Winter,1976,5,3,3,11,840
USA,Winter,1980,2,24,4,30,840
USA,Winter,1984,0,4,5,9,840
USA,Winter,1988,4,2,1,7,840
USA,Winter,1992,2,5,7,14,840
USA,Winter,1994,5,6,8,19,840
USA,Winter,1998,5,25,4,34,840
USA,Winter,2002,15,11,58,84,840
USA,Winter,2006,32,9,11,52,840
USA,Winter,2010,22,12,63,97,840
USA,Winter,2014,24,10,30,64,840
UZB,Summer,1996,1,0,1,2,860
UZB,Summer,2000,2,1,1,4,860
UZB,Summer,2004,2,2,1,5,860
UZB,Summer,2008,3,1,2,6,860
UZB,Summer,2012,2,1,0,3,860
UZB,Summer,2016,7,4,2,13,860
UZB,Winter,1994,0,1,0,1,860
VEN,Summer,1952,1,0,0,1,862
VEN,Summer,1960,1,0,0,1,862
VEN,Summer,1968,0,1,0,1,862
VEN,Summer,1976,0,0,1,1,862
VEN,Summer,1980,0,0,1,1,862
VEN,Summer,1984,3,0,0,3,862
VEN,Summer,2004,2,0,0,2,862
VEN,Summer,2008,1,0,0,1,862
VEN,Summer,2012,0,1,0,1,862
VEN,Summer,2016,2,0,1,3,862
VIE,Summer,2000,0,0,1,1,0
VIE,Summer,2008,0,0,1,1,0
VIE,Summer,2016,0,1,1,2,0
WIF,Summer,1960,5,0,0,5,0
YUG,Summer,1924,0,2,0,2,0
YUG,Summer,1928,10,1,1,12,0
YUG,Summer,1936,0,0,1,1,0
YUG,Summer,1948,0,0,16,16,0
YUG,Summer,1952,0,4,20,24,0
YUG,Summer,1956,0,0,23,23,0
YUG,Summer,1960,0,16,1,17,0
YUG,Summer,1964,2,2,11,15,0
YUG,Summer,1968,2,13,14,29,0
YUG,Summer,1972,2,15,1,18,0
YUG,Summer,1976,3,2,14,19,0
YUG,Summer,1980,17,13,27,57,0
YUG,Summer,1984,35,47,5,87,0
YUG,Summer,1988,21,15,27,63,0
YUG,Winter,1984,0,0,1,1,0
YUG,Winter,1988,1,0,5,6,0
ZAM,Summer,1984,1,0,0,1,0
ZAM,Summer,1996,0,0,1,1,0
ZIM,Summer,1980,0,15,0,15,0
ZIM,Summer,2004,1,1,1,3,0
ZIM,Summer,2008,0,1,3,4,0
